Rank,Release_Date,Movie_Title,USD_Production_Budget,USD_Worldwide_Gross,USD_Domestic_Gross,Year,Profit,ROI,Decade
5293,1915-08-02,The Birth of a Nation,110000,11000000,10000000,1915,10890000,9900.0,1910
5230,1916-12-24,"20,000 Leagues Under the Sea",200000,8000000,8000000,1916,7800000,3900.0,1910
5299,1920-09-17,Over the Hill to the Poorhouse,100000,3000000,3000000,1920,2900000,2900.0,1920
5222,1925-01-01,The Big Parade,245000,22000000,11000000,1925,21755000,8879.591836734695,1920
4250,1925-12-30,Ben-Hur,3900000,9000000,9000000,1925,5100000,130.76923076923077,1920
5141,1929-01-02,The Broadway Melody,379000,4358000,2800000,1929,3979000,1049.8680738786281,1920
5043,1931-12-31,Mata Hari,558000,900000,900000,1931,342000,61.29032258064516,1930
5017,1933-07-04,King Kong,672000,10000650,10000000,1933,9328650,1388.1919642857144,1930
5234,1933-09-02,She Done Him Wrong,200000,2000000,2000000,1933,1800000,900.0,1930
5120,1933-09-03,42nd Street,439000,2281000,1438000,1933,1842000,419.5899772209567,1930
5154,1934-01-01,It Happened One Night,325000,2500000,2500000,1934,2175000,669.2307692307693,1930
5025,1935-06-09,Top Hat,609000,3202000,1782000,1935,2593000,425.7799671592775,1930
4738,1936-05-02,Modern Times,1500000,165049,163245,1936,-1334951,-88.99673333333334,1930
4768,1936-06-26,San Francisco,1300000,5273000,2868000,1936,3973000,305.61538461538464,1930
4570,1938-01-01,Alexander's Ragtime Band,2000000,4000000,4000000,1938,2000000,100.0,1930
4693,1938-01-01,You Can't Take It With You,1644000,4000000,4000000,1938,2356000,143.30900243309003,1930
4712,1939-01-01,Mr. Smith Goes To Washington,1500000,9000000,9000000,1939,7500000,500.0,1930
4447,1939-08-25,The Wizard of Oz,2777000,33754967,33711566,1939,30977967,1115.519157364062,1930
4248,1939-12-15,Gone with the Wind,3900000,390525192,198680470,1939,386625192,9913.466461538463,1930
4556,1940-01-01,Boom Town,2000000,9172000,9172000,1940,7172000,358.59999999999997,1940
4783,1940-01-01,Rebecca,1288000,6000000,6000000,1940,4712000,365.8385093167702,1940
4524,1940-11-13,Fantasia,2280000,83320000,83320000,1940,81040000,3554.385964912281,1940
5283,1942-11-16,Cat People,134000,8000000,4000000,1942,7866000,5870.149253731343,1940
4839,1943-01-23,Casablanca,1039000,10462500,10462500,1943,9423500,906.977863330125,1940
4457,1943-12-24,A Guy Named Joe,2627000,5363000,5363000,1943,2736000,104.14921964217739,1940
4515,1944-01-01,Bathing Beauty,2361000,3500000,3500000,1944,1139000,48.24227022448115,1940
3949,1944-01-08,Wilson,5200000,2000000,2000000,1944,-3200000,-61.53846153846154,1940
4530,1945-01-01,The Valley of Decision,2160000,9132000,9132000,1945,6972000,322.77777777777777,1940
4785,1945-01-01,The Lost Weekend,1250000,11000000,11000000,1945,9750000,780.0,1940
4716,1945-10-31,Spellbound,1500000,7000000,7000000,1945,5500000,366.66666666666663,1940
4327,1946-01-01,It's a Wonderful Life,3180000,9576159,6600000,1946,6396159,201.13707547169813,1940
4545,1946-01-01,Notorious,2000000,24464742,24464742,1946,22464742,1123.2371,1940
4533,1946-11-21,The Best Years of Our Lives,2100000,23600000,23600000,1946,21500000,1023.8095238095237,1940
3845,1946-12-31,Duel in the Sun,6000000,20400000,20400000,1946,14400000,240.0,1940
4557,1947-01-01,Gentleman's Agreement,2000000,7800000,7800000,1947,5800000,290.0,1940
4260,1948-01-01,The Pirate,3700000,2956000,2956000,1948,-744000,-20.10810810810811,1940
4361,1948-01-01,Red River,3000000,9012000,9012000,1948,6012000,200.4,1940
4695,1949-01-01,She Wore a Yellow Ribbon,1600000,5400000,5400000,1949,3800000,237.5,1940
4857,1949-01-01,Sands of Iwo Jima,1000000,7800000,7800000,1949,6800000,680.0,1940
4434,1950-02-15,Cinderella,2900000,263591415,85000000,1950,260691415,8989.359137931035,1950
4255,1950-05-17,Annie Get Your Gun,3768785,8000000,8000000,1950,4231215,112.27000213596689,1950
3593,1951-02-23,Quo Vadis?,8250000,30022000,30000000,1951,21772000,263.9030303030303,1950
4797,1951-03-07,Strangers on a Train,1200000,7000000,7000000,1951,5800000,483.3333333333333,1950
4666,1951-09-18,A Streetcar Named Desire,1800000,8000000,8000000,1951,6200000,344.44444444444446,1950
4517,1951-09-24,Show Boat,2300000,11000000,11000000,1951,8700000,378.2608695652174,1950
5009,1952-01-01,High Noon,730000,8000000,8000000,1952,7270000,995.890410958904,1950
4166,1952-10-01,The Greatest Show on Earth,4000000,36000000,36000000,1952,32000000,800.0,1950
4468,1952-10-04,Singin' in the Rain,2540000,7200000,7200000,1952,4660000,183.46456692913387,1950
4788,1953-01-21,Niagara,1250000,2500000,2500000,1953,1250000,100.0,1950
4162,1953-05-02,Peter Pan,4000000,87400000,87400000,1953,83400000,2085.0,1950
4692,1953-05-08,From Here to Eternity,1650000,30500000,30500000,1953,28850000,1748.4848484848485,1950
5227,1953-06-13,"The Beast from 20,000 Fathoms",210000,5000000,5000000,1953,4790000,2280.952380952381,1950
3969,1953-09-16,The Robe,5000000,36000000,36000000,1953,31000000,620.0,1950
5018,1953-10-04,House of Wax,658000,23800000,23800000,1953,23142000,3517.0212765957444,1950
3999,1954-01-01,The Egyptian,5000000,15000000,15000000,1954,10000000,200.0,1950
4959,1954-07-28,On the Waterfront,910000,9600000,9600000,1954,8690000,954.945054945055,1950
3973,1954-12-23,"20,000 Leagues Under the Sea",5000000,28200000,28200000,1954,23200000,463.99999999999994,1950
4798,1955-03-10,The Trouble With Harry,1200000,7000000,7000000,1955,5800000,483.3333333333333,1950
3853,1956-01-01,War and Peace,6000000,12500000,12500000,1956,6500000,108.33333333333333,1950
4119,1956-01-01,Moby Dick,4500000,10400000,10400000,1956,5900000,131.11111111111111,1950
4177,1956-01-01,Trapeze,4000000,14400000,14400000,1956,10400000,260.0,1950
4856,1956-01-01,Love Me Tender,1000000,9000000,9000000,1956,8000000,800.0,1950
4310,1956-02-16,Carousel,3380000,3220,0,1956,-3376780,-99.90473372781065,1950
3020,1956-05-10,The Ten Commandments,13500000,80000000,80000000,1956,66500000,492.59259259259255,1950
3835,1956-10-17,Around the World in 80 Days,6000000,42000000,42000000,1956,36000000,600.0,1950
5067,1956-11-19,Shichinin no samurai,500000,271736,271736,1956,-228264,-45.6528,1950
4804,1956-12-23,The Wrong Man,1200000,2000000,2000000,1956,800000,66.66666666666666,1950
4015,1957-01-01,A Farewell To Arms,5000000,11014685,11000000,1957,6014685,120.29369999999999,1950
4337,1957-12-18,The Bridge on the River Kwai,3000000,33300000,33300000,1957,30300000,1010.0,1950
4348,1958-09-20,Cat on a Hot Tin Roof,3000000,17570324,17570324,1958,14570324,485.67746666666665,1950
4016,1959-01-01,Solomon and Sheba,5000000,11000000,11000000,1959,6000000,120.0,1950
4274,1959-01-01,The Nun's Story,3500000,12800000,12800000,1959,9300000,265.7142857142857,1950
4440,1959-03-29,Some Like it Hot,2883848,25000000,25000000,1959,22116152,766.8972844615944,1950
2802,1959-11-18,Ben-Hur,15000000,73000000,73000000,1959,58000000,386.6666666666667,1950
4171,1960-01-01,Exodus,4000000,21750000,21750000,1960,17750000,443.75,1960
4347,1960-01-01,The Apartment,3000000,24600000,18600000,1960,21600000,720.0,1960
4357,1960-01-01,Elmer Gantry,3000000,10400000,10400000,1960,7400000,246.66666666666669,1960
3151,1960-07-10,Spartacus,12000000,60000000,30000000,1960,48000000,400.0,1960
3185,1960-10-24,The Alamo,12000000,7900000,7900000,1960,-4100000,-34.166666666666664,1960
4189,1961-01-01,The Misfits,4000000,8200000,8200000,1961,4200000,105.0,1960
4359,1961-01-01,Judgment at Nuremberg,3000000,10000000,10000000,1961,7000000,233.33333333333334,1960
4436,1961-01-01,Pocketful of Miracles,2900000,5000000,5000000,1961,2100000,72.41379310344827,1960
4558,1961-09-25,The Hustler,2000000,7600000,7600000,1961,5600000,280.0,1960
3834,1961-10-18,West Side Story,6000000,43700000,43700000,1961,37700000,628.3333333333334,1960
4322,1962-01-01,The Man Who Shot Liberty Valance,3200000,8000000,8000000,1962,4800000,150.0,1960
4555,1962-01-01,Lolita,2000000,9250000,9250000,1962,7250000,362.5,1960
3320,1962-04-10,The Longest Day,10000000,50100000,39100000,1962,40100000,401.0,1960
2546,1962-08-11,Mutiny on The Bounty,19000000,13680000,13680000,1962,-5320000,-28.000000000000004,1960
4122,1962-09-03,State Fair,4500000,3500000,3500000,1962,-1000000,-22.22222222222222,1960
2827,1962-12-16,Lawrence of Arabia,15000000,69995385,37495385,1962,54995385,366.6359,1960
4550,1962-12-25,To Kill A Mockingbird,2000000,13129846,13129846,1962,11129846,556.4923,1960
2698,1963-01-01,55 Days at Peking,17000000,10000000,10000000,1963,-7000000,-41.17647058823529,1960
4454,1963-01-01,Donovan's Reef,2686000,6600000,6600000,1963,3914000,145.71854058078927,1960
4478,1963-05-29,Hud,2500000,10000000,10000000,1963,7500000,300.0,1960
4842,1963-07-10,Tom Jones,1000000,37600000,37600000,1963,36600000,3660.0,1960
3501,1963-07-11,It's a Mad Mad Mad Mad World,9400000,60000000,46300000,1963,50600000,538.2978723404256,1960
4849,1963-08-05,Dr. No,1000000,59567035,16067035,1963,58567035,5856.7035,1960
4181,1963-08-08,The Great Escape,4000000,11744471,11744471,1963,7744471,193.611775,1960
1253,1963-12-06,Cleopatra,42000000,71000000,57000000,1963,29000000,69.04761904761905,1960
2552,1964-01-01,The Fall of the Roman Empire,19000000,4750000,4750000,1964,-14250000,-75.0,1960
4664,1964-01-29,Dr. Strangelove,1800000,9164370,9164370,1964,7364370,409.13166666666666,1960
4543,1964-08-04,From Russia With Love,2000000,78900000,24800000,1964,76900000,3845.0000000000005,1960
3832,1964-08-26,Mary Poppins,6000000,102300000,102300000,1964,96300000,1605.0,1960
2670,1964-10-22,My Fair Lady,17000000,72070955,72000000,1964,55070955,323.946794117647,1960
5040,1964-11-08,A Hard Day's Night,560000,1597233,1537860,1964,1037233,185.22017857142856,1960
4334,1964-12-22,Goldfinger,3000000,124900000,51100000,1964,121900000,4063.3333333333335,1960
3594,1965-02-03,The Sound of Music,8200000,286214286,163214286,1965,278014286,3390.4181219512197,1960
2425,1965-02-15,The Greatest Story Ever Told,20000000,15473333,15473333,1965,-4526667,-22.633335,1960
3907,1965-07-03,The Train,5800000,6800000,6800000,1965,1000000,17.24137931034483,1960
4254,1965-07-04,Major Dundee,3800000,14873,14873,1965,-3785127,-99.60860526315788,1960
3241,1965-12-22,Doctor Zhivago,11000000,111859493,111721000,1965,100859493,916.9044818181819,1960
3514,1965-12-29,Thunderball,9000000,141200000,63600000,1965,132200000,1468.888888888889,1960
4276,1966-02-23,Harper,3500000,12000000,12000000,1966,8500000,242.85714285714283,1960
4354,1966-07-16,Torn Curtain,3000000,13000000,13000000,1966,10000000,333.33333333333337,1960
2831,1966-10-10,Hawaii,15000000,34562222,34562222,1966,19562222,130.41481333333334,1960
4249,1966-12-12,A Man for All Seasons,3900000,28350000,28350000,1966,24450000,626.9230769230769,1960
4273,1967-01-01,In Cold Blood,3500000,13007551,13000000,1967,9507551,271.6443142857143,1960
5232,1967-01-18,Per un pugno di dollari,200000,3500000,3500000,1967,3300000,1650.0,1960
4546,1967-02-08,In the Heat of the Night,2000000,24391108,24379978,1967,22391108,1119.5554,1960
3159,1967-04-28,Casino Royale,12000000,41744718,22744718,1967,29744718,247.87265,1960
3496,1967-06-13,You Only Live Twice,9500000,111600000,43100000,1967,102100000,1074.7368421052631,1960
5029,1967-10-05,Per qualche dollaro in più,600000,4300000,4300000,1967,3700000,616.6666666666667,1960
4799,1967-12-29,"Il buono, il brutto, il cattivo",1200000,6100000,6100000,1967,4900000,408.3333333333333,1960
4757,1968-01-01,Shalako,1455000,2620000,2620000,1968,1165000,80.06872852233677,1960
3295,1968-02-04,2001: A Space Odyssey,10500000,68700000,56700000,1968,58200000,554.2857142857142,1960
4667,1968-03-08,Hang 'em High,1800000,6800000,6800000,1968,5000000,277.77777777777777,1960
5008,1968-06-25,La mariée était en noir ,747000,44566,44566,1968,-702434,-94.03400267737617,1960
3906,1968-08-02,The Planet of the Apes,5800000,33395426,33395426,1968,27595426,475.78320689655175,1960
3323,1968-11-12,Oliver!,10000000,37402877,37402877,1968,27402877,274.02877,1960
4321,1968-12-06,Rosemary's Baby,3200000,33395426,33395426,1968,30195426,943.6070625,1960
2465,1969-01-01,Sweet Charity,20000000,8000000,8000000,1969,-12000000,-60.0,1960
4263,1969-05-25,Midnight Cowboy,3600000,44785053,44785053,1969,41185053,1144.02925,1960
4032,1969-05-28,C'era una volta il West,5000000,5321508,5321508,1969,321508,6.43016,1960
3883,1969-06-18,The Wild Bunch,6000000,509424,509424,1969,-5490576,-91.5096,1960
2375,1969-10-15,Paint Your Wagon,20000000,31678778,31678778,1969,11678778,58.393890000000006,1960
3831,1969-10-24,Butch Cassidy and the Sundance Kid,6000000,102308900,102308900,1969,96308900,1605.1483333333333,1960
2175,1969-12-16,"Hello, Dolly",24000000,33208099,33208099,1969,9208099,38.36707916666667,1960
3613,1969-12-18,On Her Majesty's Secret Service,8000000,82000000,22800000,1969,74000000,925.0,1960
4195,1969-12-19,Topaz,4000000,6000000,6000000,1969,2000000,50.0,1960
2270,1970-01-01,Darling Lili,22000000,5000000,5000000,1970,-17000000,-77.27272727272727,1970
3136,1970-01-01,Patton,12000000,62500000,62500000,1970,50500000,420.8333333333333,1970
3277,1970-01-01,The Molly Maguires,11000000,2200000,2200000,1970,-8800000,-80.0,1970
4265,1970-01-01,M*A*S*H,3500000,81600000,81600000,1970,78100000,2231.428571428571,1970
4855,1970-01-01,Beyond the Valley of the Dolls,1000000,9000000,9000000,1970,8000000,800.0,1970
5027,1970-03-26,Woodstock,600000,34505110,34505110,1970,33905110,5650.8516666666665,1970
4259,1970-05-13,The Ballad of Cable Hogue,3716946,5000000,3500000,1970,1283054,34.51903794136369,1970
4349,1970-05-26,Beneath the Planet of the Apes,3000000,17489009,17489009,1970,14489009,482.9669666666667,1970
2598,1970-06-24,Catch-22,18000000,24911670,24911670,1970,6911670,38.39816666666667,1970
2076,1970-09-23,"Tora, Tora, Tora",25000000,29548291,29548291,1970,4548291,18.193164,1970
3512,1971-01-01,Fiddler on the Roof,9000000,80500000,80500000,1971,71500000,794.4444444444445,1970
3809,1971-01-01,The Andromeda Strain,6500000,12376563,12376563,1971,5876563,90.40866153846154,1970
4477,1971-01-01,Escape from the Planet of the Apes,2500000,12300000,12300000,1971,9800000,392.0,1970
4379,1971-06-30,Willy Wonka & the Chocolate Factory,3000000,4000000,4000000,1971,1000000,33.33333333333333,1970
4526,1971-09-10,The French Connection,2200000,41158757,41158757,1971,38958757,1770.8525909090908,1970
3705,1971-12-17,Diamonds Are Forever,7200000,116000000,43800000,1971,108800000,1511.111111111111,1970
4686,1972-01-01,Conquest of the Planet of the Apes,1700000,9700000,9700000,1972,8000000,470.5882352941177,1970
3709,1972-03-15,The Godfather,7000000,268500000,134966411,1972,261500000,3735.7142857142853,1970
4275,1972-06-21,Frenzy,3500000,12600000,12600000,1972,9100000,260.0,1970
5314,1972-08-30,The Last House on the Left,87000,3100000,3100000,1972,3013000,3463.218390804597,1970
4548,1972-11-08,Everything You Always Wanted to Know,2000000,18016290,18016290,1972,16016290,800.8145000000001,1970
4665,1973-01-01,Battle for the Planet of the Apes,1800000,8800000,8800000,1973,7000000,388.88888888888886,1970
4106,1973-05-23,Pat Garrett and Billy the Kid,4638783,11000000,8000000,1973,6361217,137.13116134123973,1970
3714,1973-06-27,Live and Let Die,7000000,161800000,35400000,1973,154800000,2211.4285714285716,1970
3926,1973-08-22,High Plains Drifter,5500000,15700000,15700000,1973,10200000,185.45454545454544,1970
4547,1973-12-17,Sleeper,2000000,18344729,18344729,1973,16344729,817.2364500000001,1970
3921,1973-12-25,The Sting,5500000,159616327,159616327,1973,154116327,2802.115036363636,1970
3121,1973-12-26,The Exorcist,12000000,400214478,202347346,1973,388214478,3235.1206500000003,1970
4458,1974-01-01,Blazing Saddles,2600000,119500000,119500000,1974,116900000,4496.153846153846,1970
3720,1974-03-29,The Great Gatsby,7000000,26533200,26533200,1974,19533200,279.0457142857143,1970
4696,1974-07-04,The Conversation,1600000,4420000,4420000,1974,2820000,176.25,1970
3038,1974-11-12,The Godfather: Part II,13000000,57300000,57300000,1974,44300000,340.7692307692308,1970
5049,1974-11-15,Benji,500000,31559560,31559560,1974,31059560,6211.912,1970
4442,1974-12-15,Young Frankenstein,2800000,86300000,86300000,1974,83500000,2982.1428571428573,1970
2961,1974-12-17,Towering Inferno,14000000,139700000,116000000,1974,125700000,897.8571428571428,1970
4176,1974-12-17,The Front Page,4000000,15000000,15000000,1974,11000000,275.0,1970
3726,1974-12-20,The Man with the Golden Gun,7000000,97600000,21000000,1974,90600000,1294.2857142857142,1970
3261,1975-01-01,Barry Lyndon,11000000,20169934,20000000,1975,9169934,83.36303636363637,1970
3968,1975-05-16,The Return of the Pink Panther,5000000,41833347,41833347,1975,36833347,736.6669400000001,1970
3120,1975-06-20,Jaws,12000000,470700000,260000000,1975,458700000,3822.5,1970
5125,1975-10-05,Monty Python and the Holy Grail,400000,5028948,3427696,1975,4628948,1157.2369999999999,1970
4344,1975-10-06,Love and Death,3000000,20123742,20123742,1975,17123742,570.7914,1970
4145,1975-11-19,One Flew Over the Cuckoo's Nest,4400000,108981275,108981275,1975,104581275,2376.847159090909,1970
3723,1976-01-01,Logan's Run,7000000,25000000,25000000,1976,18000000,257.14285714285717,1970
4251,1976-01-01,Network,3800000,23689877,23689877,1976,19889877,523.4178157894737,1970
4805,1976-01-01,The Blue Bird,1200000,887000,887000,1976,-313000,-26.083333333333332,1970
4146,1976-06-25,Silent Movie,4400000,36145695,36145695,1976,31745695,721.4930681818182,1970
4443,1976-06-25,The Omen,2800000,48570885,48570885,1976,45770885,1634.6744642857143,1970
4844,1976-08-02,Taxi Driver,1000000,28316211,28262574,1976,27316211,2731.6211,1970
4353,1976-09-04,Family Plot,3000000,13200000,13200000,1976,10200000,340.0,1970
4025,1976-11-03,Robin and Marian,5000000,8000000,8000000,1976,3000000,60.0,1970
4661,1976-11-16,Carrie,1800000,25878153,25878153,1976,24078153,1337.6751666666667,1970
2202,1976-12-17,King Kong,23000000,90614445,52614445,1976,67614445,293.9758478260869,1970
5051,1977-01-01,Kingdom of the Spiders,500000,17000000,17000000,1977,16500000,3300.0,1970
5297,1977-01-01,Eraserhead,100000,7012524,7000000,1977,6912524,6912.524,1970
3326,1977-03-11,Pete’s Dragon,10000000,36000000,36000000,1977,26000000,260.0,1970
4165,1977-04-20,Annie Hall,4000000,38251425,38251425,1977,34251425,856.285625,1970
3765,1977-05-08,March or Die,7000000,1000000,1000000,1977,-6000000,-85.71428571428571,1970
3239,1977-05-25,Star Wars Ep. IV: A New Hope,11000000,786598007,460998007,1977,775598007,7050.890972727272,1970
1978,1977-06-15,A Bridge Too Far,26000000,50800000,50800000,1977,24800000,95.38461538461539,1970
2980,1977-06-17,Exorcist II: The Heretic,14000000,25011000,25011000,1977,11011000,78.64999999999999,1970
2989,1977-06-22,"New York, New York",14000000,13800000,13800000,1977,-200000,-1.4285714285714286,1970
2278,1977-06-24,Sorcerer,21600000,12000000,12000000,1977,-9600000,-44.44444444444444,1970
2969,1977-07-13,The Spy Who Loved Me,14000000,185400000,46800000,1977,171400000,1224.2857142857142,1970
5028,1977-10-08,The Kentucky Fried Movie,600000,20000000,15000000,1977,19400000,3233.3333333333335,1970
2309,1977-11-16,Close Encounters of the Third Kind,20000000,337700000,166000000,1977,317700000,1588.5,1970
4304,1977-12-23,High Anxiety,3400000,31063038,31063038,1977,27663038,813.6187647058824,1970
3009,1978-01-01,Caravans,14000000,1000000,1000000,1978,-13000000,-92.85714285714286,1970
3165,1978-01-01,The Boys from Brazil,12000000,19000000,19000000,1978,7000000,58.333333333333336,1970
4338,1978-01-01,Coming Home,3000000,32653000,32653000,1978,29653000,988.4333333333334,1970
3260,1978-04-13,F.I.S.T,11000000,20388920,20388920,1978,9388920,85.35381818181818,1970
2318,1978-06-16,Jaws 2,20000000,208900376,102922376,1978,188900376,944.50188,1970
3828,1978-06-16,Grease,6000000,387513770,181813770,1978,381513770,6358.562833333333,1970
2798,1978-06-28,Heaven Can Wait,15000000,98800000,98800000,1978,83800000,558.6666666666667,1970
4330,1978-07-28,National Lampoon's Animal House,3000000,141600000,141600000,1978,138600000,4620.0,1970
4382,1978-09-13,Days of Heaven,3000000,3660880,3446749,1978,660880,22.029333333333334,1970
2186,1978-10-24,The Wiz,24000000,13000000,13000000,1978,-11000000,-45.83333333333333,1970
912,1978-12-15,Superman,55000000,300200000,134218018,1978,245200000,445.8181818181818,1970
4026,1978-12-22,Force 10 from Navarone,5000000,7100000,7100000,1978,2100000,42.0,1970
2814,1979-01-01,The Deer Hunter,15000000,50000000,50000000,1979,35000000,233.33333333333334,1970
3885,1979-02-02,The First Great Train Robbery,6000000,391942,391942,1979,-5608058,-93.46763333333334,1970
4717,1979-04-20,Dawn of the Dead,1500000,55000000,5100000,1979,53500000,3566.6666666666665,1970
3106,1979-05-25,The Prisoner of Zenda,12500000,7000000,7000000,1979,-5500000,-44.0,1970
3510,1979-05-25,Alien,9000000,203630630,80930630,1979,194630630,2162.5625555555553,1970
3160,1979-06-15,Prophecy,12000000,22673340,22673340,1979,10673340,88.9445,1970
3598,1979-06-22,The Muppet Movie,8000000,76657000,76657000,1979,68657000,858.2125,1970
3604,1979-06-22,Escape from Alcatraz,8000000,43000000,43000000,1979,35000000,437.5,1970
1696,1979-06-29,Moonraker,31000000,210300000,70300000,1979,179300000,578.3870967741935,1970
5266,1979-06-30,Dolphin,170000,14000,14000,1979,-156000,-91.76470588235294,1970
3573,1979-07-11,The Rose,8500000,29200000,29200000,1979,20700000,243.52941176470586,1970
1521,1979-07-12,Star Trek: The Motion Picture,35000000,139000000,82258456,1979,104000000,297.14285714285717,1970
1691,1979-08-15,Apocalypse Now,31500000,81250488,78800000,1979,49750488,157.93805714285713,1970
4173,1979-08-17,The Life of Brian,4000000,20008693,20008693,1979,16008693,400.217325,1970
4449,1979-10-17,The Black Stallion,2700000,37799643,37799643,1979,35099643,1299.986777777778,1970
2759,1979-10-19,Meteor,16000000,8400000,8400000,1979,-7600000,-47.5,1970
1676,1979-12-14,1941,32000000,94875000,34175000,1979,62875000,196.484375,1970
2361,1979-12-21,The Black Hole,20000000,35841901,35841901,1979,15841901,79.20950500000001,1970
1624,1980-01-01,Lion of the Desert,35000000,1500000,1500000,1980,-33500000,-95.71428571428572,1980
3805,1980-01-01,Dressed to Kill,6500000,31899000,31899000,1980,25399000,390.75384615384615,1980
4279,1980-01-01,Terror Train,3500000,8000000,8000000,1980,4500000,128.57142857142858,1980
5144,1980-01-01,Maniac,350000,10000000,10000000,1980,9650000,2757.1428571428573,1980
4846,1980-01-02,The Fog,1000000,21378361,21378361,1980,20378361,2037.8361000000002,1980
1414,1980-01-08,Raise the Titanic,40000000,7000000,7000000,1980,-33000000,-82.5,1980
3952,1980-03-10,Somewhere in Time,5100000,9709597,9709597,1980,4609597,90.38425490196079,1980
3977,1980-03-10,The Elephant Man,5000000,26010864,26010864,1980,21010864,420.21727999999996,1980
4264,1980-04-07,Airplane!,3500000,83453539,83453539,1980,79953539,2284.386828571429,1980
1573,1980-05-12,Flash Gordon,35000000,27107960,27107960,1980,-7892040,-22.548685714285714,1980
3374,1980-05-16,The Long Riders,10000000,15198912,15198912,1980,5198912,51.98912,1980
5132,1980-05-16,Home Movies,400000,89134,89134,1980,-310866,-77.7165,1980
2196,1980-05-21,Star Wars Ep. V: The Empire Strikes Back,23000000,534171960,290271960,1980,511171960,2222.4867826086956,1980
2536,1980-05-23,The Shining,19000000,44391156,44017374,1980,25391156,133.63766315789474,1980
3929,1980-06-06,Galaxina,5500000,4865000,4865000,1980,-635000,-11.545454545454545,1980
2261,1980-06-13,The Island,22000000,15716828,15716828,1980,-6283172,-28.55987272727273,1980
1941,1980-06-20,The Blues Brothers,27000000,57229890,57229890,1980,30229890,111.96255555555557,1980
2490,1980-06-20,Can't Stop the Music,20000000,2000000,2000000,1980,-18000000,-90.0,1980
4115,1980-06-20,The Blue Lagoon,4500000,47923795,47923795,1980,43423795,964.9732222222223,1980
2805,1980-07-03,Coal Miner's Daughter,15000000,67182787,67182787,1980,52182787,347.88524666666666,1980
3836,1980-07-25,Caddyshack,6000000,39846344,39846344,1980,33846344,564.1057333333333,1980
3833,1980-09-19,Ordinary People,6000000,52302978,52302978,1980,46302978,771.7163,1980
5301,1980-10-05,Penitentiary,100000,287000,287000,1980,187000,187.0,1980
2804,1980-10-10,Private Benjamin,15000000,69847348,69847348,1980,54847348,365.64898666666664,1980
2600,1980-11-14,Raging Bull,18000000,23380203,23380203,1980,5380203,29.890016666666668,1980
1238,1980-11-19,Heaven's Gate,44000000,3484523,3484331,1980,-40515477,-92.08062954545456,1980
2340,1980-12-12,Popeye,20000000,49823037,49823037,1980,29823037,149.115185,1980
2707,1981-01-01,Roar,17000000,2110050,2110050,1981,-14889950,-87.58794117647058,1980
5185,1981-01-05,Graduation Day,250000,23894000,23894000,1981,23644000,9457.599999999999,1980
3177,1981-03-20,The Postman Always Rings Twice,12000000,44200000,12200000,1981,32200000,268.3333333333333,1980
1642,1981-04-12,Reds,33500000,50000000,50000000,1981,16500000,49.25373134328358,1980
4784,1981-04-30,Friday the 13th Part 2,1250000,21722776,21722776,1981,20472776,1637.8220800000001,1980
2617,1981-05-22,The Legend of the Lone Ranger,18000000,13400000,13400000,1981,-4600000,-25.555555555555554,1980
3804,1981-05-22,The Four Seasons,6500000,42488161,42488161,1981,35988161,553.6640153846154,1980
3143,1981-06-11,Time Bandits,12000000,37400000,37400000,1981,25400000,211.66666666666666,1980
969,1981-06-19,Superman II,54000000,108185706,108185706,1981,54185706,100.34389999999999,1980
1896,1981-06-26,For Your Eyes Only,28000000,195300000,54800000,1981,167300000,597.5,1980
2625,1981-06-26,Dragonslayer,18000000,6000000,6000000,1981,-12000000,-66.66666666666666,1980
3306,1981-06-26,Stripes,10000000,85300000,85300000,1981,75300000,753.0,1980
3504,1981-07-08,Heavy Metal,9300000,19571091,19571091,1981,10271091,110.44183870967741,1980
2615,1981-07-24,Blow Out,18000000,13747234,13747234,1981,-4252766,-23.626477777777776,1980
2409,1981-07-31,Under the Rainbow,20000000,18826490,18826490,1981,-1173510,-5.86755,1980
4370,1981-08-28,Gallipoli,3000000,5732587,5732587,1981,2732587,91.08623333333334,1980
2971,1981-09-12,Taps,14000000,35856053,35856053,1981,21856053,156.11466428571427,1980
3992,1981-09-18,Mommie Dearest,5000000,25032000,19032000,1981,20032000,400.64000000000004,1980
3922,1981-09-25,Chariots of Fire,5500000,57467731,57159946,1981,51967731,944.8678363636363,1980
4001,1981-10-04,Nighthawks,5000000,19600000,14600000,1981,14600000,292.0,1980
4848,1981-10-04,The Howling,1000000,17985000,17985000,1981,16985000,1698.5,1980
3840,1981-10-07,Escape from New York,6000000,25244700,25244700,1981,19244700,320.745,1980
4474,1981-10-30,Halloween II,2500000,25533818,25533818,1981,23033818,921.35272,1980
3427,1981-11-02,Sphinx,10000000,11400000,2000000,1981,1400000,14.000000000000002,1980
3201,1981-11-13,The Pursuit of D.B. Cooper,12000000,2104164,2104164,1981,-9895836,-82.4653,1980
2306,1981-12-06,Raiders of the Lost Ark,20000000,389925971,248159971,1981,369925971,1849.629855,1980
2843,1981-12-06,Clash of the Titans,15000000,44400000,30000000,1981,29400000,196.0,1980
3256,1981-12-06,History of the World: Part I,11000000,31672000,31672000,1981,20672000,187.9272727272727,1980
3409,1981-12-18,Heartbeeps,10000000,6000000,6000000,1981,-4000000,-40.0,1980
3612,1981-12-25,Modern Problems,8000000,24474312,24474312,1981,16474312,205.92890000000003,1980
3024,1982-01-29,The Border,13500000,6118683,6118683,1982,-7381317,-54.67642222222222,1980
3105,1982-02-04,Cat People,12500000,21000000,7000000,1982,8500000,68.0,1980
4011,1982-02-04,Diner,5000000,12592907,12592907,1982,7592907,151.85814,1980
3988,1982-03-11,The Man From Snowy River,5000000,20659423,20659423,1982,15659423,313.18845999999996,1980
4161,1982-03-19,Porky's,4000000,109492484,109492484,1982,105492484,2637.3121,1980
3127,1982-04-06,Star Trek II: The Wrath of Khan,12000000,95800000,78912963,1982,83800000,698.3333333333334,1980
3290,1982-04-06,Poltergeist,10700000,121706019,74706019,1982,111006019,1037.439429906542,1980
2355,1982-05-14,Conan the Barbarian,20000000,79114085,38264085,1982,59114085,295.570425,1980
4544,1982-05-21,Mad Max 2: The Road Warrior,2000000,24600832,24600832,1982,22600832,1130.0416,1980
2286,1982-06-18,Firefox,21000000,45785720,45785720,1982,24785720,118.02723809523809,1980
1908,1982-06-25,Blade Runner,28000000,33139618,32656328,1982,5139618,18.355778571428573,1980
2629,1982-06-25,Megaforce,18000000,5675599,5675599,1982,-12324401,-68.46889444444444,1980
2304,1982-07-23,The Best Little Whorehouse in Texas,20500000,69701637,69701637,1982,49201637,240.00798536585367,1980
2240,1982-08-12,Gandhi,22000000,127767889,52767889,1982,105767889,480.7631318181818,1980
2728,1982-08-12,The Verdict,16000000,53977250,53977250,1982,37977250,237.3578125,1980
4116,1982-08-13,Fast Times at Ridgemont High,4500000,27092880,27092880,1982,22592880,502.064,1980
4525,1982-08-13,Friday the 13th Part 3,2250000,36690067,36690067,1982,34440067,1530.6696444444444,1980
4017,1982-08-20,The Beastmaster,5000000,10751126,10751126,1982,5751126,115.02252,1980
4318,1982-08-20,Class of 1984,3250000,6965361,6965361,1982,3715361,114.31880000000001,1980
4041,1982-08-27,Jekyll and Hyde... Together Again,5000000,3707583,3707583,1982,-1292417,-25.848339999999997,1980
2688,1982-09-07,Tron,17000000,26918576,26918576,1982,9918576,58.34456470588235,1980
1158,1982-09-17,Inchon,46000000,4408636,4408636,1982,-41591364,-90.41600869565217,1980
3179,1982-10-02,Das Boot,12000000,84970337,11487676,1982,72970337,608.0861416666667,1980
3616,1982-10-11,Creepshow,8000000,20036244,20036244,1982,12036244,150.45305,1980
2968,1982-10-22,First Blood,14000000,125212904,47212904,1982,111212904,794.3778857142858,1980
4475,1982-10-22,Halloween 3: Season of the Witch,2500000,14400000,14400000,1982,11900000,476.0,1980
3294,1982-11-06,ET: The Extra-Terrestrial,10500000,792965326,435110554,1982,782465326,7452.050723809523,1980
4808,1982-11-19,Q,1200000,255000,255000,1982,-945000,-78.75,1980
3099,1982-12-02,La Guerre du feu,12500000,20959585,20959585,1982,8459585,67.67668,1980
2790,1982-12-17,Tootsie,15000000,177200000,177200000,1982,162200000,1081.3333333333333,1980
5131,1983-01-01,E tu vivrai nel terrore - L'aldilà,400000,126387,126387,1983,-273613,-68.40325,1980
3300,1983-02-18,Lovesick,10100000,10143618,10143618,1983,43618,0.43186138613861386,1980
3129,1983-03-06,WarGames,12000000,74433837,74433837,1983,62433837,520.281975,1980
3350,1983-03-25,The Outsiders,10000000,25697647,25697647,1983,15697647,156.97646999999998,1980
3903,1983-04-02,Videodrome,5952000,2120439,2120439,1983,-3831561,-64.37434475806452,1980
3711,1983-04-15,Flashdance,7000000,201463574,90463574,1983,194463574,2778.051057142857,1980
4012,1983-04-15,Lone Wolf McQuade,5000000,12232628,12232628,1983,7232628,144.65256,1980
5142,1983-04-15,The Evil Dead,375000,29400000,2400000,1983,29025000,7740.000000000001,1980
1657,1983-05-25,Star Wars Ep. VI: Return of the Jedi,32500000,572705079,309205079,1983,540205079,1662.1694738461538,1980
1437,1983-06-17,Superman III,39000000,59950623,59950623,1983,20950623,53.71954615384615,1980
3342,1983-06-24,Twilight Zone: The Movie,10000000,29500000,29500000,1983,19500000,195.0,1980
1493,1983-07-10,Never Say Never Again,36000000,160000000,55500000,1983,124000000,344.44444444444446,1980
2808,1983-07-29,National Lampoon’s Vacation,15000000,61400000,61400000,1983,46400000,309.3333333333333,1980
3763,1983-08-04,Losin' It,7000000,1246141,1246141,1983,-5753859,-82.19798571428572,1980
4767,1983-08-19,The Ballad of Gregorio Cortez,1305000,909000,909000,1983,-396000,-30.344827586206897,1980
2048,1983-09-12,Scarface,25000000,44942821,44942821,1983,19942821,79.771284,1980
2896,1983-09-30,Brainstorm,15000000,8921050,8921050,1983,-6078950,-40.52633333333333,1980
1929,1983-10-06,Octopussy,27500000,187500000,67900000,1983,160000000,581.8181818181819,1980
1949,1983-10-21,The Right Stuff,27000000,21500000,21500000,1983,-5500000,-20.37037037037037,1980
3357,1983-10-21,The Dead Zone,10000000,20766000,20766000,1983,10766000,107.66,1980
3648,1983-10-28,The Wicked Lady,8000000,589308,589308,1983,-7410692,-92.63365,1980
3140,1983-11-18,Yentl,12000000,39012241,39012241,1983,27012241,225.10200833333332,1980
4317,1983-11-18,A Christmas Story,3250000,20605209,20605209,1983,17355209,534.0064307692307,1980
1841,1984-01-06,Once Upon a Time in America,30000000,5564014,5321508,1984,-24435986,-81.45328666666667,1980
2570,1984-01-06,Star Trek III: The Search for Spock,18000000,87000000,76471046,1984,69000000,383.33333333333337,1980
4722,1984-02-03,Repo Man,1500000,2300000,2300000,1984,800000,53.333333333333336,1980
3595,1984-02-17,Footloose,8200000,80000000,80000000,1984,71800000,875.609756097561,1980
3529,1984-03-16,The Ice Pirates,9000000,13075390,13075390,1984,4075390,45.282111111111114,1980
4113,1984-03-23,Police Academy,4500000,81198894,81198894,1984,76698894,1704.4198666666666,1980
4459,1984-04-13,Friday the 13th Part IV: The Final Chapter,2600000,32980880,32980880,1984,30380880,1168.4953846153846,1980
5045,1984-04-27,Love Letters,550000,5269990,5269990,1984,4719990,858.18,1980
2788,1984-05-12,Beverly Hills Cop,15000000,316300000,234760478,1984,301300000,2008.6666666666665,1980
1882,1984-05-23,Indiana Jones and the Temple of Doom,28000000,333080271,179880271,1984,305080271,1089.5723964285714,1980
3597,1984-06-22,The Karate Kid,8000000,90815558,90815558,1984,82815558,1035.194475,1980
2596,1984-06-29,Conan the Destroyer,18000000,26400000,26400000,1984,8400000,46.666666666666664,1980
1950,1984-07-20,Die Unendliche Geschichte,27000000,21300000,21300000,1984,-5700000,-21.11111111111111,1980
1704,1984-08-06,Ghostbusters,30000000,295212467,242212467,1984,265212467,884.0415566666668,1980
3240,1984-08-06,Gremlins,11000000,148168459,148168459,1984,137168459,1246.9859909090908,1980
2133,1984-08-17,Sheena,25000000,5778353,5778353,1984,-19221647,-76.886588,1980
4786,1984-08-31,C.H.U.D.,1250000,4700000,4700000,1984,3450000,276.0,1980
3599,1984-09-03,Splash,8000000,62599495,62599495,1984,54599495,682.4936875,1980
3686,1984-09-03,The Hotel New Hampshire,7500000,5142858,5142858,1984,-2357142,-31.42856,1980
4662,1984-09-11,A Nightmare on Elm Street,1800000,25504513,25504513,1984,23704513,1316.9173888888888,1980
2581,1984-09-19,Amadeus,18000000,51973029,51973029,1984,33973029,188.73905,1980
3392,1984-10-26,Body Double,10000000,8801940,8801940,1984,-1198060,-11.980599999999999,1980
3820,1984-10-26,The Terminator,6400000,78019031,38019031,1984,71619031,1119.0473593749998,1980
2871,1984-11-05,Firestarter,15000000,15136870,15136870,1984,136870,0.9124666666666666,1980
1139,1984-12-14,The Cotton Club,48000000,25928721,25928721,1984,-22071279,-45.98183125,1980
1204,1984-12-14,Dune,45000000,27447471,27447471,1984,-17552529,-39.00562,1980
1933,1984-12-14,A Passage to India,27500000,27187653,27187653,1984,-312347,-1.1358072727272728,1980
4342,1985-01-11,A Nightmare On Elm Street Part 2: Freddy's Revenge,3000000,21163999,21163999,1985,18163999,605.4666333333333,1980
4724,1985-01-18,Blood Simple,1500000,2730877,1690913,1985,1230877,82.05846666666666,1980
2527,1985-03-07,Back to the Future,19000000,385524862,212259762,1985,366524862,1929.0782210526318,1980
4775,1985-03-15,Def-Con 4,1300000,210904,210904,1985,-1089096,-83.77661538461538,1980
3333,1985-03-22,The Last Dragon,10000000,33000000,33000000,1985,23000000,229.99999999999997,1980
4527,1985-03-22,Friday the 13th Part V: A New Beginning,2200000,21930418,21930418,1985,19730418,896.8371818181819,1980
3328,1985-04-10,Commando,10000000,35073978,35073978,1985,25073978,250.73978000000002,1980
2604,1985-04-12,Young Sherlock Holmes,18000000,19739000,19739000,1985,1739000,9.661111111111111,1980
1233,1985-05-22,Rambo: First Blood Part II,44000000,300400000,150415432,1985,256400000,582.7272727272727,1980
1762,1985-05-24,A View to a Kill,30000000,152627960,50327960,1985,122627960,408.75986666666665,1980
4592,1985-06-11,Subway,2000000,1663296,390659,1985,-336704,-16.8352,1980
1955,1985-06-21,Return to Oz,27000000,10618813,10618813,1985,-16381187,-60.671062962962964,1980
2117,1985-06-21,Lifeforce,25000000,11603545,11603545,1985,-13396455,-53.58582,1980
2654,1985-06-28,Red Sonja,17900000,6905861,6905861,1985,-10994139,-61.41977094972068,1980
3788,1985-06-28,Pale Rider,6900000,41410568,41410568,1985,34510568,500.15315942028985,1980
4283,1985-06-30,Day of the Dead,3500000,34004262,5804262,1985,30504262,871.5503428571429,1980
3132,1985-08-02,Witness,12000000,65532576,65532576,1985,53532576,446.1048,1980
4178,1985-08-16,The Return of the Living Dead,4000000,14237880,14237880,1985,10237880,255.947,1980
3365,1985-09-27,Invasion U.S.A.,10000000,17536256,17536256,1985,7536256,75.36256,1980
1986,1985-10-07,Silverado,26000000,33200000,33200000,1985,7200000,27.692307692307693,1980
3325,1985-10-07,Mad Max Beyond Thunderdome,10000000,36230219,36230219,1985,26230219,262.30219,1980
4356,1985-10-25,Krush Groove,3000000,11052713,11052713,1985,8052713,268.42376666666667,1980
3737,1985-11-10,Silver Bullet,7000000,10803211,10803211,1985,3803211,54.331585714285715,1980
2410,1985-12-04,Ladyhawke,20000000,18400000,18400000,1985,-1600000,-8.0,1980
1695,1985-12-18,Out of Africa,31000000,258210860,79096868,1985,227210860,732.9382580645162,1980
2799,1985-12-18,The Color Purple,15000000,93589701,93589701,1985,78589701,523.9313400000001,1980
2890,1985-12-18,Brazil,15000000,9930649,9929135,1985,-5069351,-33.79567333333333,1980
1424,1986-01-07,Pirates,40000000,6341825,1641825,1986,-33658175,-84.1454375,1980
2121,1986-01-07,Big Trouble in Little China,25000000,11100000,11100000,1986,-13900000,-55.60000000000001,1980
1822,1986-01-08,Howard the Duck,30000000,16295774,16295774,1986,-13704226,-45.680753333333335,1980
4345,1986-01-08,Friday the 13th Part VI: Jason Lives,3000000,19472057,19472057,1986,16472057,549.0685666666667,1980
2921,1986-01-17,The Clan of the Cave Bear,15000000,1953732,1953732,1986,-13046268,-86.97511999999999,1980
2623,1986-02-21,Nine 1/2 Weeks,18000000,6734844,6734844,1986,-11265156,-62.5842,1980
1623,1986-03-10,Playing for Keeps,35000000,2000000,2000000,1986,-33000000,-94.28571428571428,1980
4010,1986-03-27,April Fool's Day,5000000,12947763,12947763,1986,7947763,158.95526,1980
2102,1986-04-18,Legend,25000000,23506237,15502112,1986,-1493763,-5.975052,1980
4125,1986-04-23,Salvador,4500000,1500000,1500000,1986,-3000000,-66.66666666666666,1980
2641,1986-04-25,8 Million Ways to Die,18000000,1305114,1305114,1986,-16694886,-92.74936666666666,1980
2789,1986-05-16,Top Gun,15000000,356800601,179800601,1986,341800601,2278.670673333333,1980
3193,1986-06-06,Invaders from Mars,12000000,4984663,4884663,1986,-7015337,-58.46114166666667,1980
1340,1986-06-18,Legal Eagles,40000000,49851591,49851591,1986,9851591,24.628977499999998,1980
2760,1986-07-03,Highlander,16000000,12900000,5900000,1986,-3100000,-19.375,1980
4343,1986-07-03,A Room with a View,3000000,20966644,20966644,1986,17966644,598.8881333333334,1980
2667,1986-07-18,Aliens,17000000,183316455,85160248,1986,166316455,978.3320882352941,1980
3602,1986-08-08,Stand by Me,8000000,52287414,52287414,1986,44287414,553.592675,1980
5261,1986-08-08,She's Gotta Have It,175000,7137502,7137502,1986,6962502,3978.572571428571,1980
4101,1986-08-22,The Texas Chainsaw Massacre 2,4700000,8025872,8025872,1986,3325872,70.7632340425532,1980
2705,1986-08-29,Shanghai Surprise,17000000,2315000,2315000,1986,-14685000,-86.38235294117646,1980
3564,1986-09-26,Crocodile Dundee,8800000,328203506,174803506,1986,319403506,3629.5852954545453,1980
2586,1986-10-10,Peggy Sue Got Married,18000000,41382841,41382841,1986,23382841,129.90467222222222,1980
3314,1986-10-17,The Color of Money,10000000,52293000,52293000,1986,42293000,422.93,1980
2164,1986-11-26,Star Trek IV: The Voyage Home,24000000,133000000,109713132,1986,109000000,454.1666666666667,1980
3126,1986-12-12,The Golden Child,12000000,79817937,79817937,1986,67817937,565.149475,1980
1779,1986-12-19,Little Shop of Horrors,30000000,38747385,38747385,1986,8747385,29.15795,1980
3829,1986-12-19,Platoon,6000000,137963328,137963328,1986,131963328,2199.3887999999997,1980
4559,1986-12-31,Witchboard,2000000,7369373,7369373,1986,5369373,268.46865,1980
4461,1987-01-01,Maurice,2600000,3147950,3147950,1987,547950,21.075,1980
5145,1987-01-01,American Ninja 2: The Confrontation,350000,4000000,4000000,1987,3650000,1042.857142857143,1980
5298,1987-01-03,Hollywood Shuffle,100000,5228617,5228617,1987,5128617,5128.617,1980
3423,1987-01-05,Malone,10000000,3000000,3000000,1987,-7000000,-70.0,1980
4272,1987-01-05,Creepshow 2,3500000,14000000,14000000,1987,10500000,300.0,1980
2751,1987-01-30,Radio Days,16000000,14792779,14792779,1987,-1207221,-7.545131250000001,1980
3965,1987-02-27,A Nightmare On Elm Street 3: Dream Warriors,5000000,44793222,44793222,1987,39793222,795.86444,1980
2026,1987-03-06,The Untouchables,25000000,76270454,76270454,1987,51270454,205.081816,1980
4282,1987-03-13,Evil Dead II,3500000,5923044,5923044,1987,2423044,69.22982857142857,1980
4209,1987-03-31,The Barbarians,4000000,800000,800000,1987,-3200000,-80.0,1980
4827,1987-04-09,The Offspring,1100000,1355728,1355728,1987,255728,23.247999999999998,1980
1400,1987-05-15,Ishtar,40000000,14375181,14375181,1987,-25624819,-64.06204749999999,1980
2310,1987-05-20,Beverly Hills Cop II,20000000,276665036,153665036,1987,256665036,1283.3251799999998,1980
2806,1987-06-03,Lethal Weapon,15000000,120192350,65192350,1987,105192350,701.2823333333333,1980
1877,1987-06-11,Cry Freedom,29000000,25899797,5899797,1987,-3100203,-10.690355172413794,1980
2227,1987-06-24,Spaceballs,22700000,38119483,38119483,1987,15419483,67.92723788546256,1980
2213,1987-07-17,Jaws 4: The Revenge,23000000,15728335,15728335,1987,-7271665,-31.615934782608697,1980
3040,1987-07-17,RoboCop,13000000,53424681,53424681,1987,40424681,310.9590846153846,1980
2697,1987-07-24,Superman IV: The Quest for Peace,17000000,11227824,11227824,1987,-5772176,-33.95397647058824,1980
3803,1987-07-24,La Bamba,6500000,54215416,54215416,1987,47715416,734.0833230769231,1980
1337,1987-07-31,The Living Daylights,40000000,191200000,51185000,1987,151200000,378.0,1980
3572,1987-07-31,The Lost Boys,8500000,32222567,32222567,1987,23722567,279.08902352941175,1980
4649,1987-08-05,River's Edge,1900000,4600000,4600000,1987,2700000,142.10526315789474,1980
2959,1987-09-18,Fatal Attraction,14000000,320100000,156645693,1987,306100000,2186.4285714285716,1980
4850,1987-09-18,Hellraiser,1000000,14564000,14564000,1987,13564000,1356.4,1980
2839,1987-09-25,The Princess Bride,15000000,30857000,30857000,1987,15857000,105.71333333333332,1980
2717,1987-11-12,Wall Street,16500000,43848100,43848100,1987,27348100,165.7460606060606,1980
1783,1987-11-13,The Running Man,30000000,38122000,38122000,1987,8122000,27.073333333333334,1980
2050,1987-11-20,The Last Emperor,25000000,43988888,43984987,1987,18988888,75.955552,1980
4364,1987-11-20,Teen Wolf Too,3000000,7888000,7888000,1987,4888000,162.93333333333334,1980
2791,1987-11-25,3 Men and a Baby,15000000,167780960,167780960,1987,152780960,1018.5397333333333,1980
2576,1987-12-06,Predator,18000000,98267558,59735548,1987,80267558,445.9308777777777,1980
3031,1987-12-23,Good Morning Vietnam,13000000,123922370,123922370,1987,110922370,853.2489999999999,1980
2100,1988-01-04,"Bright Lights, Big City",25000000,16118077,16118077,1988,-8881923,-35.527692,1980
3994,1988-01-10,Halloween 4: The Return of Michael Myers,5000000,17768757,17768757,1988,12768757,255.37514,1980
4200,1988-01-12,Talk Radio,4000000,3468572,3468572,1988,-531428,-13.2857,1980
3825,1988-01-15,Return of the Living Dead Part II,6200000,9205924,9205924,1988,3005924,48.48264516129032,1980
4711,1988-02-26,Bloodsport,1500000,11806119,11806119,1988,10306119,687.0745999999999,1980
2567,1988-03-06,Big,18000000,151668774,114968774,1988,133668774,742.6043,1980
2801,1988-03-30,Beetle Juice,15000000,73326666,73326666,1988,58326666,388.84444,1980
4215,1988-04-03,Prison,4000000,354704,354704,1988,-3645296,-91.1324,1980
4179,1988-04-11,They Live,4000000,13000000,13000000,1988,9000000,225.0,1980
4102,1988-04-22,Lady in White,4700000,1705139,1705139,1988,-2994861,-63.72044680851063,1980
4445,1988-05-13,Friday the 13th Part VII: The New Blood,2800000,19170001,19170001,1988,16370001,584.6428928571428,1980
884,1988-05-25,Rambo III,58000000,188715611,53715611,1988,130715611,225.37174310344827,1980
2962,1988-05-25,Crocodile Dundee 2,14000000,239606210,109306210,1988,225606210,1611.4729285714286,1980
638,1988-06-22,Who Framed Roger Rabbit?,70000000,351500000,154112492,1988,281500000,402.1428571428571,1980
1885,1988-07-15,Die Hard,28000000,139109346,81350242,1988,111109346,396.81909285714283,1980
1781,1988-07-20,Midnight Run,30000000,81613606,38413606,1988,51613606,172.04535333333334,1980
4366,1988-08-07,Phantasm II,3000000,7282851,7282851,1988,4282851,142.7617,1980
3041,1988-08-19,A Nightmare on Elm Street 4: The Dream Master,13000000,49369899,49369899,1988,36369899,279.7684538461538,1980
3519,1988-09-11,Child's Play,9000000,44196684,33244684,1988,35196684,391.0742666666667,1980
2755,1988-09-12,My Stepmother Is an Alien,16000000,13854000,13854000,1988,-2146000,-13.4125,1980
2795,1988-09-12,Twins,15000000,216600000,111936388,1988,201600000,1344.0,1980
3497,1988-10-06,Poltergeist III,9500000,14114000,14114000,1988,4614000,48.56842105263158,1980
3851,1988-10-21,Mystic Pizza,6000000,12793213,12793213,1988,6793213,113.22021666666666,1980
3119,1988-11-18,The Land Before Time,12300000,81972846,48092846,1988,69672846,566.4459024390244,1980
1667,1988-11-23,Scrooged,32000000,59450353,59450353,1988,27450353,85.782353125,1980
3727,1988-12-02,Action Jackson,7000000,20257000,20257000,1988,13257000,189.3857142857143,1980
3849,1988-12-02,School Daze,6000000,14545844,14545844,1988,8545844,142.43073333333334,1980
3045,1988-12-08,Young Guns,13000000,44726644,44726644,1988,31726644,244.0511076923077,1980
3743,1988-12-08,The Last Temptation of Christ,7000000,8373585,8373585,1988,1373585,19.622642857142857,1980
2008,1988-12-16,Rain Man,25000000,412800000,172825435,1988,387800000,1551.2,1980
2974,1988-12-21,Dangerous Liaisons,14000000,34700000,34700000,1988,20700000,147.85714285714286,1980
2886,1989-01-03,New York Stories,15000000,10763469,10763469,1989,-4236531,-28.24354,1980
2724,1989-02-06,Dead Poets Society,16400000,239500000,95860116,1989,223100000,1360.3658536585365,1980
3319,1989-02-17,Bill & Ted's Excellent Adventure,10000000,40485039,40485039,1989,30485039,304.85039,1980
2622,1989-03-22,Troop Beverly Hills,18000000,7190505,7190505,1989,-10809495,-60.052749999999996,1980
4793,1989-04-08,"Sex, Lies, and Videotape",1200000,36741667,24741667,1989,35541667,2961.8055833333333,1980
3235,1989-04-21,Pet Sematary,11500000,57469179,57469179,1989,45969179,399.73199130434784,1980
3340,1989-05-19,Road House,10000000,30050028,30050028,1989,20050028,200.50028000000003,1980
1124,1989-05-24,Indiana Jones and the Last Crusade,48000000,474171806,197171806,1989,426171806,887.8579291666666,1980
1510,1989-06-23,Batman,35000000,411348924,251188924,1989,376348924,1075.28264,1980
3839,1989-06-30,Do the Right Thing,6000000,26004026,26004026,1989,20004026,333.4004333333333,1980
3248,1989-07-04,Major League,11000000,49793054,49793054,1989,38793054,352.6641272727273,1980
1260,1989-07-14,Licence to Kill,42000000,156167015,34667015,1989,114167015,271.8262261904762,1980
2726,1989-07-14,When Harry Met Sally…,16000000,92961960,92823546,1989,76961960,481.01225000000005,1980
4028,1989-07-21,UHF,5000000,6157157,6157157,1989,1157157,23.143140000000002,1980
4002,1989-07-28,Friday the 13th Part VIII: Jason Takes Manhattan,5000000,14343976,14343976,1989,9343976,186.87952,1980
4710,1989-08-09,Kickboxer,1500000,14533681,14533681,1989,13033681,868.9120666666665,1980
3532,1989-08-11,Henry V,9000000,10176701,10161099,1989,1176701,13.074455555555556,1980
1758,1989-09-06,Star Trek V: The Final Frontier,30000000,70200000,52210049,1989,40200000,134.0,1980
662,1989-09-08,The Abyss,70000000,54243125,54243125,1989,-15756875,-22.509821428571428,1980
2532,1989-09-15,Sea of Love,19000000,58571513,58571513,1989,39571513,208.27112105263157,1980
1765,1989-09-22,Black Rain,30000000,45892212,45892212,1989,15892212,52.97404,1980
3856,1989-10-13,Halloween 5: The Revenge of Michael Myers,6000000,11642254,11642254,1989,5642254,94.03756666666668,1980
3843,1989-11-08,A Nightmare On Elm Street: The Dream Child,6000000,22168359,22168359,1989,16168359,269.47265,1980
1744,1989-11-17,Harlem Nights,30000000,95857262,60857262,1989,65857262,219.5242066666667,1980
1285,1989-11-22,Back to the Future Part II,40000000,332000000,118450002,1989,292000000,730.0,1980
2595,1989-12-13,Glory,18000000,26593580,26593580,1989,8593580,47.742111111111114,1980
3677,1989-12-13,Driving Miss Daisy,7500000,106593296,106593296,1989,99093296,1321.2439466666665,1980
2451,1989-12-15,We're No Angels,20000000,10555348,10555348,1989,-9444652,-47.22326,1980
2963,1989-12-20,Born on the Fourth of July,14000000,70001698,70001698,1989,56001698,400.0121285714286,1980
5281,1989-12-20,Roger & Me,140000,6706368,6706368,1989,6566368,4690.262857142857,1980
933,1989-12-22,Tango & Cash,55000000,63408614,63408614,1989,8408614,15.28838909090909,1980
4699,1989-12-31,Out of the Dark,1600000,419428,419428,1989,-1180572,-73.78575000000001,1980
714,1990-01-06,Total Recall,65000000,261400000,119394839,1990,196400000,302.1538461538462,1990
3368,1990-01-19,Tremors,10000000,16667084,16667084,1990,6667084,66.67084,1990
1711,1990-02-03,The Hunt for Red October,30000000,200500000,120709866,1990,170500000,568.3333333333334,1990
3675,1990-02-23,The Blood of Heroes,7700000,882290,882290,1990,-6817710,-88.54168831168832,1990
644,1990-03-07,Die Hard 2,70000000,239814025,117323878,1990,169814025,242.59146428571427,1990
3370,1990-03-08,Mo' Better Blues,10000000,16153000,16153000,1990,6153000,61.529999999999994,1990
5121,1990-03-08,Metropolitan,430000,2938000,2938000,1990,2508000,583.2558139534884,1990
2958,1990-03-23,Pretty Woman,14000000,432645872,178406268,1990,418645872,2990.327657142857,1990
3019,1990-03-30,Teenage Mutant Ninja Turtles,13500000,202000000,135265915,1990,188500000,1396.2962962962963,1990
4352,1990-04-27,Spaced Invaders,3000000,15000000,15000000,1990,12000000,400.0,1990
1300,1990-05-24,Back to the Future Part III,40000000,244088654,88055283,1990,204088654,510.221635,1990
1061,1990-06-15,Gremlins 2: The New Batch,50000000,41476097,41476097,1990,-8523903,-17.047805999999998,1990
1142,1990-06-15,Dick Tracy,47000000,162738726,103738726,1990,115738726,246.25260851063828,1990
796,1990-06-27,Days of Thunder,60000000,157670733,82670733,1990,97670733,162.784555,1990
2338,1990-07-12,Edward Scissorhands,20000000,53976987,53976987,1990,33976987,169.88493499999998,1990
2231,1990-07-13,Ghost,22000000,517600000,217631306,1990,495600000,2252.7272727272725,1990
1699,1990-07-18,Arachnophobia,31000000,53208180,53208180,1990,22208180,71.63929032258064,1990
2528,1990-09-11,Dances with Wolves,19000000,424200000,184208842,1990,405200000,2132.631578947369,1990
3053,1990-09-11,Child's Play 2,13000000,34166572,26904572,1990,21166572,162.81978461538463,1990
2046,1990-09-19,Goodfellas,25000000,46777347,46743809,1990,21777347,87.109388,1990
3752,1990-09-28,Dark Angel,7000000,4372561,4372561,1990,-2627439,-37.534842857142856,1990
1974,1990-10-08,Flatliners,26000000,61308153,61308153,1990,35308153,135.80058846153847,1990
2399,1990-10-19,Quigley Down Under,20000000,21413105,21413105,1990,1413105,7.065525,1990
4154,1990-10-19,Night of the Living Dead,4200000,5835247,5835247,1990,1635247,38.934452380952386,1990
1122,1990-11-07,The Adventures of Ford Fairlane,49000000,20423389,20423389,1990,-28576611,-58.31961428571428,1990
2787,1990-11-16,Home Alone,15000000,476684675,285761243,1990,461684675,3077.8978333333334,1990
1571,1990-11-21,Predator 2,35000000,54768418,28317513,1990,19768418,56.48119428571429,1990
1970,1990-12-21,Kindergarten Cop,26000000,202000000,91457688,1990,176000000,676.9230769230769,1990
973,1990-12-25,The Godfather: Part III,54000000,66520529,66520529,1990,12520529,23.186164814814813,1990
3278,1991-01-01,Return to the Blue Lagoon,11000000,2000000,2000000,1991,-9000000,-81.81818181818183,1990
3642,1991-01-01,Showdown in Little Tokyo,8000000,2275557,2275557,1991,-5724443,-71.5555375,1990
5074,1991-01-01,Johnny Suede,500000,55000,55000,1991,-445000,-89.0,1990
5111,1991-01-01,Straight out of Brooklyn,450000,2712293,2712293,1991,2262293,502.73177777777784,1990
1362,1991-01-03,The Doors,40000000,34416893,34416893,1991,-5583107,-13.957767500000001,1990
3576,1991-01-03,Haakon Haakonsen,8500000,15024232,15024232,1991,6524232,76.75567058823529,1990
5345,1991-01-07,The Last Waltz,35000,321952,321952,1991,286952,819.8628571428571,1990
5363,1991-01-08,Slacker,23000,1227508,1227508,1991,1204508,5236.991304347826,1990
1599,1991-01-18,Flight of the Intruder,35000000,14471440,14471440,1991,-20528560,-58.653028571428564,1990
2973,1991-01-18,White Fang,14000000,34729091,34729091,1991,20729091,148.06493571428572,1990
327,1991-02-07,Terminator 2: Judgment Day,100000000,513815401,201858746,1991,413815401,413.815401,1990
2314,1991-02-14,The Silence of the Lambs,20000000,275726716,130726716,1991,255726716,1278.63358,1990
2024,1991-03-22,Teenage Mutant Ninja Turtles II: The Secret of the Ooze,25000000,78656813,78656813,1991,53656813,214.627252,1990
2130,1991-05-17,Stone Cold,25000000,9286314,9286314,1991,-15713686,-62.854744,1990
749,1991-05-24,Hudson Hawk,65000000,17218916,17218916,1991,-47781084,-73.50936,1990
1938,1991-06-12,Star Trek VI: The Undiscovered Country,27000000,96900000,74888996,1991,69900000,258.8888888888889,1990
1005,1991-06-14,Robin Hood: Prince of Thieves,50000000,390500000,165493908,1991,340500000,681.0,1990
2198,1991-06-28,The Naked Gun 2½: The Smell of Fear,23000000,86930411,86930411,1991,63930411,277.9583086956522,1990
2357,1991-07-19,Bill & Ted's Bogus Journey,20000000,37537675,37537675,1991,17537675,87.688375,1990
3750,1991-08-03,Nikita,7000000,5017971,5017971,1991,-1982029,-28.3147,1990
2219,1991-08-23,Harley Davidson and the Marlboro Man,23000000,7018525,7018525,1991,-15981475,-69.48467391304348,1990
3882,1991-08-30,Beastmaster 2: Through the Portal of Time,6000000,773490,773490,1991,-5226510,-87.1085,1990
2739,1991-09-08,Double Impact,16000000,29090445,29090445,1991,13090445,81.81528125,1990
3970,1991-09-13,Freddy's Dead: The Final Nightmare,5000000,34872033,34872033,1991,29872033,597.44066,1990
2173,1991-09-20,The Fisher King,24000000,41798224,41798224,1991,17798224,74.15926666666667,1990
4480,1991-09-29,My Own Private Idaho,2500000,6401336,6401336,1991,3901336,156.05344000000002,1990
3742,1991-10-01,Warlock,7000000,8824553,8824553,1991,1824553,26.065042857142856,1990
3989,1991-10-23,House Party 2,5000000,19438638,19438638,1991,14438638,288.77276,1990
3548,1991-10-25,Due occhi diabolici,9000000,349618,349618,1991,-8650382,-96.11535555555555,1990
643,1991-11-12,Hook,70000000,300854823,119654823,1991,230854823,329.7926042857143,1990
2307,1991-11-13,Beauty and the Beast,20000000,451329842,218951625,1991,431329842,2156.64921,1990
1524,1991-11-15,Cape Fear,35000000,182291969,79091969,1991,147291969,420.83419714285714,1990
1716,1991-11-22,The Addams Family,30000000,191502246,113502246,1991,161502246,538.34082,1990
2716,1991-11-27,My Girl,16500000,58011485,58011485,1991,41511485,251.58475757575758,1990
2172,1991-12-07,Point Break,24000000,83531958,43218387,1991,59531958,248.049825,1990
3802,1991-12-07,Boyz n the Hood,6500000,56200634,56190094,1991,49700634,764.6251384615384,1990
1315,1991-12-20,JFK,40000000,205400000,70405498,1991,165400000,413.5,1990
1732,1991-12-25,The Prince of Tides,30000000,74787599,74787599,1991,44787599,149.29199666666665,1990
3244,1991-12-27,Fried Green Tomatoes,11000000,81204830,81204830,1991,70204830,638.2257272727272,1990
3749,1992-01-05,Split Second,7000000,5430822,5430822,1992,-1569178,-22.41682857142857,1990
1251,1992-01-07,Boomerang,42000000,131052444,70052444,1992,89052444,212.0296285714286,1990
1289,1992-01-07,A League of Their Own,40000000,132440066,107533925,1992,92440066,231.100165,1990
1265,1992-02-10,Hero,42000000,66787173,19487173,1992,24787173,59.01707857142857,1990
3316,1992-02-10,The Mighty Ducks,10000000,50752337,50752337,1992,40752337,407.52337,1990
2315,1992-02-14,Wayne's World,20000000,183097323,121697323,1992,163097323,815.486615,1990
1620,1992-02-21,Radio Flyer,35000000,4651977,4651977,1992,-30348023,-86.70863714285714,1990
1401,1992-02-28,Memoirs of an Invisible Man,40000000,14358033,14358033,1992,-25641967,-64.1049175,1990
3246,1992-03-13,My Cousin Vinny,11000000,52929168,52929168,1992,41929168,381.1742545454545,1990
3609,1992-03-13,Howards End,8000000,26199377,26124872,1992,18199377,227.4922125,1990
4049,1992-04-24,A Midnight Clear,5000000,1526697,1526697,1992,-3473303,-69.46606,1990
1171,1992-05-06,Patriot Games,45000000,178100000,83287363,1992,133100000,295.77777777777777,1990
1513,1992-05-15,Lethal Weapon 3,35000000,319700000,144731527,1992,284700000,813.4285714285713,1990
938,1992-05-22,Alien 3,55000000,158500000,54927174,1992,103500000,188.1818181818182,1990
3334,1992-06-03,The Lawnmower Man,10000000,32100816,32100816,1992,22100816,221.00816,1990
491,1992-06-18,Batman Returns,80000000,266824291,162833635,1992,186824291,233.53036375,1990
1346,1992-07-02,Medicine Man,40000000,44948240,44948240,1992,4948240,12.3706,1990
2956,1992-07-08,Unforgiven,14400000,159157447,101157447,1992,144757447,1005.2600486111111,1990
3259,1992-07-08,Raising Cain,11000000,21171695,21171695,1992,10171695,92.46995454545454,1990
934,1992-07-31,Death Becomes Her,55000000,149022650,58422650,1992,94022650,170.95027272727273,1990
3734,1992-07-31,Buffy the Vampire Slayer,7000000,14231669,14231669,1992,7231669,103.30955714285714,1990
4051,1992-09-21,Light Sleeper,5000000,1050861,1050861,1992,-3949139,-78.98277999999999,1990
1308,1992-09-25,The Last of the Mohicans,40000000,75505856,75505856,1992,35505856,88.76464,1990
3103,1992-09-30,Glengarry Glen Ross,12500000,10725228,10725228,1992,-1774772,-14.198176000000002,1990
3615,1992-10-04,The Player,8000000,28876702,21706101,1992,20876702,260.958775,1990
4802,1992-10-23,Reservoir Dogs,1200000,2832029,2832029,1992,1632029,136.00241666666665,1990
1881,1992-11-11,Aladdin,28000000,504050219,217350219,1992,476050219,1700.1793535714285,1990
1643,1992-11-12,A Few Good Men,33000000,236500000,141340178,1992,203500000,616.6666666666667,1990
3153,1992-11-12,The Muppet Christmas Carol,12000000,27281507,27281507,1992,15281507,127.34589166666667,1990
1304,1992-11-13,Bram Stoker's Dracula,40000000,215862692,82522790,1992,175862692,439.65673,1990
1543,1992-11-18,Malcolm X,35000000,48169910,48169910,1992,13169910,37.62831428571429,1990
2308,1992-11-20,Home Alone 2: Lost in New York,20000000,358994850,173585516,1992,338994850,1694.97425,1990
2014,1992-11-25,The Bodyguard,25000000,410900000,121945720,1992,385900000,1543.6,1990
4163,1992-11-25,The Crying Game,4000000,62546695,62546695,1992,58546695,1463.667375,1990
1581,1992-12-25,Hoffa,35000000,28391473,23365858,1992,-6608527,-18.881505714285716,1990
4610,1993-01-01,Return of the Living Dead 3,2000000,21000,21000,1993,-1979000,-98.95,1990
4673,1993-01-01,Ed and his Dead Mother,1800000,673,673,1993,-1799327,-99.96261111111112,1990
2964,1993-01-10,Cool Runnings,14000000,155056263,68856263,1993,141056263,1007.5447357142858,1990
4983,1993-01-10,Ruby in Paradise,800000,1001437,1001437,1993,201437,25.179625,1990
1674,1993-01-15,Alive,32000000,36299670,36299670,1993,4299670,13.43646875,1990
2856,1993-01-15,Nowhere to Run,15000000,52189039,22189039,1993,37189039,247.92692666666665,1990
3806,1993-02-04,The Adventures of Huck Finn,6500000,24103594,24103594,1993,17603594,270.8245230769231,1990
3268,1993-02-19,Army of Darkness,11000000,21502976,11502976,1993,10502976,95.4816,1990
3188,1993-03-09,Fortress,12000000,46730578,6730578,1993,34730578,289.42148333333336,1990
2288,1993-03-19,Teenage Mutant Ninja Turtles III,21000000,42273609,42273609,1993,21273609,101.3029,1990
1621,1993-04-16,Bound by Honor,35000000,4496583,4496583,1993,-30503417,-87.15262,1990
2891,1993-04-23,The Dark Half,15000000,9579068,9579068,1993,-5420932,-36.13954666666667,1990
3050,1993-05-02,Loaded Weapon 1,13000000,27979399,27979399,1993,14979399,115.22614615384614,1990
2267,1993-05-11,RoboCop 3,22000000,10696210,10696210,1993,-11303790,-51.380863636363635,1990
2855,1993-05-11,The Remains of the Day,15000000,63954968,22954968,1993,48954968,326.3664533333333,1990
3085,1993-05-14,Excessive Force,13000000,1152117,1152117,1993,-11847883,-91.13756153846154,1990
4267,1993-05-26,Menace II Society,3500000,27731527,27731527,1993,24231527,692.3293428571428,1990
724,1993-05-28,Cliffhanger,65000000,255000000,84049211,1993,190000000,292.30769230769226,1990
1264,1993-05-28,Super Mario Bros.,42000000,20844907,20844907,1993,-21155093,-50.36926904761905,1990
1232,1993-06-08,The Fugitive,44000000,353715317,183875760,1993,309715317,703.8984477272727,1990
462,1993-06-18,Last Action Hero,85000000,137298489,50016394,1993,52298489,61.527634117647054,1990
1246,1993-06-30,The Firm,42000000,270340892,158340892,1993,228340892,543.6687904761905,1990
3614,1993-07-05,Much Ado About Nothing,8000000,22549338,22549338,1993,14549338,181.866725,1990
1904,1993-07-16,Hocus Pocus,28000000,39360491,39360491,1993,11360491,40.57318214285714,1990
2325,1993-07-16,Free Willy,20000000,153698625,77698625,1993,133698625,668.493125,1990
2977,1993-07-23,Poetic Justice,14000000,27450453,27450453,1993,13450453,96.07466428571428,1990
2124,1993-08-10,Gettysburg,25000000,10731997,10731997,1993,-14268003,-57.07201200000001,1990
4351,1993-08-13,Jason Goes to Hell: The Final Friday,3000000,15935068,15935068,1993,12935068,431.16893333333337,1990
3874,1993-08-27,Only the Strong,6000000,3273588,3273588,1993,-2726412,-45.4402,1990
2824,1993-09-06,What's Love Got to Do With It,15000000,39100956,39100956,1993,24100956,160.67304000000001,1990
1636,1993-09-17,The Age of Innocence,34000000,32014993,32014993,1993,-1985007,-5.838255882352941,1990
3790,1993-09-24,Dazed and Confused,6900000,7950889,7950889,1993,1050889,15.23027536231884,1990
4380,1993-09-24,Warlock: The Armageddon,3000000,3902679,3902679,1993,902679,30.0893,1990
3101,1993-10-09,True Romance,12500000,12309980,12281000,1993,-190020,-1.52016,1990
758,1993-11-06,Jurassic Park,63000000,1038812584,395708305,1993,975812584,1548.9088634920633,1990
2007,1993-11-24,Mrs. Doubtfire,25000000,441286003,219195051,1993,416286003,1665.144012,1990
2553,1993-11-24,The Nutcracker,19000000,2119994,2119994,1993,-16880006,-88.84213684210526,1990
2951,1993-12-02,Groundhog Day,14600000,70906973,70906973,1993,56306973,385.664198630137,1990
4401,1993-12-02,Braindead,3000000,242623,242623,1993,-2757377,-91.91256666666666,1990
3712,1993-12-11,The Piano,7000000,40157856,40157856,1993,33157856,473.68365714285716,1990
2015,1993-12-15,Schindler's List,25000000,321365567,96067179,1993,296365567,1185.462268,1990
1166,1993-12-17,The Pelican Brief,45000000,187995859,100768056,1993,142995859,317.76857555555557,1990
1972,1993-12-22,Philadelphia,26000000,201324422,77324422,1993,175324422,674.3247,1990
2034,1993-12-25,Tombstone,25000000,56505065,56505065,1993,31505065,126.02026,1990
3270,1993-12-25,What's Eating Gilbert Grape,11000000,9170214,9170214,1993,-1829786,-16.63441818181818,1990
2250,1993-12-29,Shadowlands,22000000,25842377,25842377,1993,3842377,17.465349999999997,1990
1102,1994-01-07,Baby's Day Out,50000000,16581575,16581575,1994,-33418425,-66.83685,1990
1369,1994-01-07,The Shadow,40000000,31835600,31835600,1994,-8164400,-20.411,1990
1067,1994-02-18,On Deadly Ground,50000000,38590458,38590458,1994,-11409542,-22.819084,1990
3363,1994-02-25,Sugar Hill,10000000,18423914,18272447,1994,8423914,84.23914,1990
1385,1994-03-06,Renaissance Man,40000000,24172899,24172899,1994,-15827101,-39.5677525,1990
762,1994-03-08,Clear and Present Danger,62000000,207500000,122012656,1994,145500000,234.6774193548387,1990
1760,1994-03-18,Naked Gun 33 1/3: The Final Insult,30000000,51041856,51041856,1994,21041856,70.13952,1990
3130,1994-04-02,Ace Ventura: Pet Detective,12000000,107217396,72217396,1994,95217396,793.4783,1990
3419,1994-04-02,Romeo Is Bleeding,10000000,3275585,3275585,1994,-6724415,-67.24415,1990
1209,1994-04-11,Frankenstein,45000000,112006296,22006296,1994,67006296,148.90288,1990
3071,1994-04-13,Serial Mom,13000000,7881335,7881335,1994,-5118665,-39.374346153846155,1990
3630,1994-04-22,The Inkwell,8000000,8864699,8864699,1994,864699,10.8087375,1990
3538,1994-04-29,PCU,9000000,4333569,4333569,1994,-4666431,-51.84923333333333,1990
2991,1994-05-13,Crooklyn,14000000,13024170,13024170,1994,-975830,-6.9702142857142855,1990
1060,1994-05-25,Beverly Hills Cop III,50000000,119180938,42586861,1994,69180938,138.361876,1990
1162,1994-05-27,The Flintstones,45000000,358500000,130531208,1994,313500000,696.6666666666666,1990
2446,1994-06-05,3 Ninjas Kick Back,20000000,11744960,11744960,1994,-8255040,-41.2752,1990
906,1994-06-07,Forrest Gump,55000000,679850637,330151138,1994,624850637,1136.0920672727273,1990
557,1994-06-15,The Lion King,79300000,987480140,422780140,1994,908180140,1145.246078184111,1990
658,1994-06-17,Wolf,70000000,131011757,65011757,1994,61011757,87.15965285714286,1990
761,1994-06-24,Wyatt Earp,63000000,25052000,25052000,1994,-37948000,-60.23492063492063,1990
1186,1994-07-10,The Specialist,45000000,57362581,57362581,1994,12362581,27.472402222222218,1990
333,1994-07-15,True Lies,100000000,365300000,146282411,1994,265300000,265.3,1990
1169,1994-07-20,The Client,45000000,117615211,92115211,1994,72615211,161.36713555555556,1990
2566,1994-07-29,The Mask,18000000,351620129,119920129,1994,333620129,1853.4451611111112,1990
3462,1994-08-26,Police Academy 7: Mission to Moscow,10000000,126247,126247,1994,-9873753,-98.73752999999999,1990
4729,1994-08-31,Killing Zoe,1500000,418953,418953,1994,-1081047,-72.0698,1990
4114,1994-09-03,Four Weddings and a Funeral,4500000,242895809,52700832,1994,238395809,5297.6846444444445,1990
924,1994-09-12,Disclosure,55000000,212200000,83015089,1994,157200000,285.8181818181818,1990
1902,1994-09-16,Timecop,28000000,102053581,44853581,1994,74053581,264.477075,1990
2079,1994-09-23,The Shawshank Redemption,25000000,28307092,28241469,1994,3307092,13.228367999999998,1990
4718,1994-09-23,Exotica,1500000,5046118,5046118,1994,3546118,236.40786666666668,1990
1195,1994-09-30,The River Wild,45000000,94215000,46815000,1994,49215000,109.36666666666666,1990
2626,1994-09-30,Ed Wood,18000000,5828466,5828466,1994,-12171534,-67.61963333333333,1990
1710,1994-10-06,Speed,30000000,283200000,121248145,1994,253200000,844.0,1990
3596,1994-10-14,Pulp Fiction,8000000,212928762,107928762,1994,204928762,2561.609525,1990
3618,1994-10-14,Wes Craven's New Nightmare,8000000,18090181,18090181,1994,10090181,126.12726249999999,1990
5010,1994-10-14,Hoop Dreams,700000,11768371,7768371,1994,11068371,1581.195857142857,1990
2437,1994-10-21,Bullets Over Broadway,20000000,13383747,13383747,1994,-6616253,-33.081265,1990
928,1994-10-28,Stargate,55000000,196565669,71565669,1994,141565669,257.39212545454546,1990
1422,1994-11-03,The Hudsucker Proxy,40000000,14938149,2816518,1994,-25061851,-62.654627500000004,1990
2503,1994-11-09,Rapa Nui,20000000,305070,305070,1994,-19694930,-98.47465,1990
1017,1994-11-11,Interview with the Vampire: The Vampire Chronicles,50000000,223564608,105264608,1994,173564608,347.129216,1990
2233,1994-11-11,The Santa Clause,22000000,189800000,144833357,1994,167800000,762.7272727272727,1990
4043,1994-11-16,Heavenly Creatures,5000000,5438120,3046086,1994,438120,8.7624,1990
1448,1994-11-18,Star Trek: Generations,38000000,120000000,75671262,1994,82000000,215.78947368421052,1990
2746,1994-11-18,Léon,16000000,45284974,19284974,1994,29284974,183.03108749999998,1990
3343,1994-11-23,A Low Down Dirty Shame,10000000,29317886,29317886,1994,19317886,193.17886,1990
2725,1994-12-16,Dumb & Dumber,16000000,246400000,127175374,1994,230400000,1440.0,1990
1355,1994-12-21,Ri¢hie Ri¢h,40000000,38087756,38087756,1994,-1912244,-4.780609999999999,1990
2813,1994-12-21,Little Women,15000000,50003303,50003303,1994,35003303,233.3553533333333,1990
1561,1994-12-23,Street Fighter,35000000,99423000,33423000,1994,64423000,184.06571428571428,1990
1734,1994-12-23,Legends of the Fall,30000000,160502573,66502573,1994,130502573,435.0085766666667,1990
1942,1994-12-25,The Jungle Book,27000000,44342956,44342956,1994,17342956,64.23317037037037,1990
3297,1994-12-31,There Goes My Baby,10500000,125169,125169,1994,-10374831,-98.80791428571428,1990
2138,1995-01-03,Tank Girl,25000000,4064333,4064333,1995,-20935667,-83.742668,1990
3017,1995-01-07,Clueless,13700000,56598476,56598476,1995,42898476,313.1275620437956,1990
2927,1995-01-12,Things to Do in Denver when You're Dead,15000000,529766,529766,1995,-14470234,-96.46822666666667,1990
3164,1995-01-13,Tales from the Crypt: Demon Knight,12000000,21089146,21089146,1995,9089146,75.74288333333334,1990
1993,1995-01-27,Highlander III: The Sorcerer,26000000,13738574,13738574,1995,-12261426,-47.15933076923077,1990
4481,1995-01-27,Before Sunrise,2500000,5683371,5274005,1995,3183371,127.33484,1990
2236,1995-02-06,The Bridges of Madison County,22000000,175516617,71516617,1995,153516617,697.8028045454545,1990
4191,1995-03-02,The Jerky Boys,4000000,7555256,7555256,1995,3555256,88.8814,1990
1104,1995-03-11,Fair Game,50000000,26097497,11497497,1995,-23902503,-47.805006,1990
2416,1995-03-11,Home for the Holidays,20000000,22119269,17468887,1995,2119269,10.596345,1990
3007,1995-03-31,Jefferson in Paris,14000000,2461628,2461628,1995,-11538372,-82.41694285714286,1990
1740,1995-04-08,Babe,30000000,246100000,63658910,1995,216100000,720.3333333333333,1990
1801,1995-04-08,Virtuosity,30000000,23998226,23998226,1995,-6001774,-20.005913333333332,1990
1398,1995-04-21,Kiss of Death,40000000,14942422,14942422,1995,-25057578,-62.643945,1990
4268,1995-04-26,Friday,3500000,27936778,27467564,1995,24436778,698.1936571428571,1990
409,1995-05-19,Die Hard: With a Vengeance,90000000,366101666,100012499,1995,276101666,306.77962888888885,1990
627,1995-05-24,Braveheart,72000000,209045522,75545647,1995,137045522,190.34100277777776,1990
3855,1995-05-24,Tales from the Hood,6000000,11784569,11784569,1995,5784569,96.40948333333334,1990
919,1995-05-26,Casper,55000000,282300000,100328194,1995,227300000,413.27272727272725,1990
1077,1995-06-10,Assassins,50000000,83306268,30306268,1995,33306268,66.612536,1990
328,1995-06-16,Batman Forever,100000000,336529144,184031112,1995,236529144,236.529144,1990
5190,1995-06-16,The Incredibly True Adventure of Two Girls in Love,250000,2477155,2210408,1995,2227155,890.8620000000001,1990
470,1995-06-30,Judge Dredd,85000000,113487912,34687912,1995,28487912,33.51519058823529,1990
710,1995-06-30,Apollo 13,65000000,334100000,172070496,1995,269100000,413.99999999999994,1990
1909,1995-07-04,Rob Roy,28000000,31390587,31390587,1995,3390587,12.109239285714287,1990
2088,1995-07-04,Don Juan DeMarco,25000000,22032635,22032635,1995,-2967365,-11.86946,1990
2199,1995-07-04,Bad Boys,23000000,141247413,65647413,1995,118247413,514.1191869565217,1990
605,1995-07-07,First Knight,75000000,127361412,37361412,1995,52361412,69.815216,1990
1534,1995-07-07,Species,35000000,113354449,60054449,1995,78354449,223.86985428571427,1990
828,1995-07-14,Under Siege 2: Dark Territory,60000000,104324083,50024083,1995,44324083,73.87347166666667,1990
1200,1995-07-14,The Indian in the Cupboard,45000000,35627222,35627222,1995,-9372778,-20.828395555555556,1990
4713,1995-07-21,Kids,1500000,20412216,7412216,1995,18912216,1260.8144,1990
93,1995-07-28,Waterworld,175000000,264246220,88246220,1995,89246220,50.997840000000004,1990
2242,1995-07-28,The Net,22000000,110521733,50621733,1995,88521733,402.3715136363636,1990
3842,1995-08-16,The Usual Suspects,6000000,34449356,23341568,1995,28449356,474.1559333333333,1990
2327,1995-08-18,Mortal Kombat,20000000,122133227,70433227,1995,102133227,510.66613500000005,1990
2193,1995-08-25,The Princess and the Cobbler,24000000,669276,669276,1995,-23330724,-97.21135,1990
3722,1995-08-25,Desperado,7000000,25532388,25532388,1995,18532388,264.7484,1990
1026,1995-09-06,Congo,50000000,152022333,81022333,1995,102022333,204.044666,1990
1391,1995-09-22,Showgirls,40000000,37750754,20350754,1995,-2249246,-5.623115,1990
1722,1995-09-22,Se7en,30000000,328125643,100125643,1995,298125643,993.7521433333334,1990
2400,1995-09-27,To Die For,20000000,27688744,21284514,1995,7688744,38.44372,1990
3998,1995-09-29,Halloween: The Curse of Michael Myers,5000000,15126948,15126948,1995,10126948,202.53896,1990
1680,1995-10-02,The Quick and the Dead,32000000,18552460,18552460,1995,-13447540,-42.0235625,1990
1034,1995-10-03,Outbreak,50000000,67823573,67823573,1995,17823573,35.647146,1990
911,1995-10-06,Pocahontas,55000000,347100000,141579773,1995,292100000,531.090909090909,1990
1717,1995-10-11,Ace Ventura: When Nature Calls,30000000,212400000,108360063,1995,182400000,608.0,1990
1107,1995-10-13,The Scarlet Letter,50000000,10359006,10359006,1995,-39640994,-79.281988,1990
1109,1995-10-13,Jade,50000000,9812870,9812870,1995,-40187130,-80.37425999999999,1990
1703,1995-10-20,Get Shorty,30250000,115021008,72021008,1995,84771008,280.2347371900826,1990
3827,1995-10-20,Mallrats,6100000,2108367,2108367,1995,-3991633,-65.43660655737705,1990
2371,1995-10-27,Copycat,20000000,32051917,32051917,1995,12051917,60.259585,1990
2982,1995-10-27,Vampire in Brooklyn,14000000,19637147,19637147,1995,5637147,40.26533571428572,1990
4168,1995-10-27,Leaving Las Vegas,4000000,49800000,31983777,1995,45800000,1145.0,1990
2718,1995-11-12,Sense and Sensibility,16500000,134993774,42993774,1995,118493774,718.1440848484849,1990
764,1995-11-17,The American President,62000000,107822813,60022813,1995,45822813,73.9077629032258,1990
784,1995-11-17,Goldeneye,60000000,356429941,106429941,1995,296429941,494.04990166666664,1990
694,1995-11-22,Money Train,68000000,77224232,35324232,1995,9224232,13.565047058823529,1990
991,1995-11-22,Casino,52000000,110400000,42438300,1995,58400000,112.3076923076923,1990
1705,1995-11-22,Toy Story,30000000,364545516,191796233,1995,334545516,1115.15172,1990
922,1995-12-05,Crimson Tide,55000000,159387195,91387195,1995,104387195,189.7949,1990
3276,1995-12-05,The Perez Family,11000000,2794056,2794056,1995,-8205944,-74.5994909090909,1990
3275,1995-12-14,Othello,11000000,2844379,2844379,1995,-8155621,-74.14200909090908,1990
720,1995-12-15,Jumanji,65000000,262758310,100458310,1995,197758310,304.2435538461538,1990
885,1995-12-15,Sabrina,58000000,87100000,53458319,1995,29100000,50.172413793103445,1990
1219,1995-12-20,Nixon,45000000,34668249,13668249,1995,-10331751,-22.959446666666665,1990
393,1995-12-22,Cutthroat Island,92000000,18517322,10017322,1995,-73482678,-79.87247608695652,1990
4197,1995-12-25,Four Rooms,4000000,4301000,4301000,1995,301000,7.5249999999999995,1990
1867,1995-12-27,Twelve Monkeys,29000000,168841459,57141459,1995,139841459,482.2119275862069,1990
1694,1995-12-29,Mr. Holland's Opus,31000000,106282604,82582604,1995,75282604,242.84710967741935,1990
2633,1995-12-29,Restoration,18000000,4100000,4100000,1995,-13900000,-77.22222222222223,1990
3251,1995-12-29,Dead Man Walking,11000000,83088295,39387284,1995,72088295,655.3481363636363,1990
3506,1995-12-29,Richard III,9200000,4199334,2684904,1995,-5000666,-54.35506521739131,1990
823,1996-01-03,Up Close & Personal,60000000,100645801,51045801,1996,40645801,67.74300166666667,1990
5379,1996-01-04,Bang,10000,527,527,1996,-9473,-94.73,1990
2953,1996-01-11,Romeo+Juliet,14500000,147542381,46338728,1996,133042381,917.5336620689656,1990
3113,1996-01-11,The Funeral,12500000,1412799,1212799,1996,-11087201,-88.69760799999999,1990
2388,1996-01-19,From Dusk Till Dawn,20000000,25732986,25728961,1996,5732986,28.66493,1990
1236,1996-02-02,The Juror,44000000,22730924,22730924,1996,-21269076,-48.33880909090909,1990
1468,1996-02-02,White Squall,38000000,10229300,10229300,1996,-27770700,-73.08078947368422,1990
573,1996-02-07,Independence Day,75000000,817400878,306169255,1996,742400878,989.8678373333332,1990
956,1996-02-08,Chain Reaction,55000000,60209334,21226204,1996,5209334,9.471516363636363,1990
3904,1996-02-08,Emma,5900000,37831658,22231658,1996,31931658,541.2145423728814,1990
1392,1996-02-16,City Hall,40000000,20278055,20278055,1996,-19721945,-49.3048625,1990
3321,1996-02-16,Happy Gilmore,10000000,41004412,38623460,1996,31004412,310.04412,1990
4055,1996-02-21,Bottle Rocket,5000000,407488,407488,1996,-4592512,-91.85024,1990
1150,1996-02-23,Mary Reilly,47000000,12900000,5707094,1996,-34100000,-72.5531914893617,1990
2638,1996-02-23,Unforgettable,18000000,2483790,2483790,1996,-15516210,-86.20116666666667,1990
3679,1996-02-23,Rumble in the Bronx,7500000,36238752,32281907,1996,28738752,383.18336,1990
3607,1996-03-04,A Thin Line Between Love & Hate,8000000,34873513,34873513,1996,26873513,335.9189125,1990
2853,1996-03-05,The Craft,15000000,55669466,24769466,1996,40669466,271.12977333333333,1990
3634,1996-03-05,The Pallbearer,8000000,5656388,5656388,1996,-2343612,-29.295149999999996,1990
936,1996-03-15,Executive Decision,55000000,122079192,56679192,1996,67079192,121.96216727272726,1990
3194,1996-03-22,Girl 6,12000000,4880941,4880941,1996,-7119059,-59.325491666666665,1990
3732,1996-03-22,Flirting with Disaster,7000000,16149180,14853474,1996,9149180,130.70257142857142,1990
1440,1996-03-29,Sgt. Bilko,39000000,37956589,30356589,1996,-1043411,-2.6754128205128205,1990
1210,1996-04-10,The Glimmer Man,45000000,36404841,20404841,1996,-8595159,-19.100353333333334,1990
3417,1996-04-10,Crash,10000000,3357324,3357324,1996,-6642676,-66.42676,1990
4120,1996-04-10,Bound,4500000,7011317,3802260,1996,2511317,55.80704444444444,1990
4473,1996-04-10,That Thing You Do!,2500000,34557416,25857416,1996,32057416,1282.29664,1990
1625,1996-04-19,Le hussard sur le toit,35000000,1320043,1320043,1996,-33679957,-96.22844857142857,1990
2129,1996-04-19,Mrs. Winterbourne,25000000,10039566,10039566,1996,-14960434,-59.841736,1990
3080,1996-05-04,Faithful,13000000,2104439,2104439,1996,-10895561,-83.81200769230769,1990
1663,1996-05-07,Phenomenon,32000000,152036382,104636382,1996,120036382,375.11369375000004,1990
2003,1996-05-17,Flipper,25530000,30593313,20080020,1996,5063313,19.832796709753232,1990
488,1996-05-21,Mission: Impossible,80000000,457697994,180981886,1996,377697994,472.12249249999996,1990
2593,1996-05-24,Spy Hard,18000000,26936265,26936265,1996,8936265,49.645916666666665,1990
899,1996-05-31,Dragonheart,57000000,104364680,51364680,1996,47364680,83.0959298245614,1990
1686,1996-06-09,Bogus,32000000,4357406,4357406,1996,-27642594,-86.38310625,1990
3516,1996-06-11,Set It Off,9000000,36049108,36049108,1996,27049108,300.54564444444446,1990
541,1996-06-12,Daylight,80000000,158908290,32908290,1996,78908290,98.6353625,1990
2452,1996-06-12,Everyone Says I Love You,20000000,34600000,9725847,1996,14600000,73.0,1990
1144,1996-06-14,The Cable Guy,47000000,102825796,60240295,1996,55825796,118.77828936170214,1990
340,1996-06-21,Eraser,100000000,234400000,101295562,1996,134400000,134.4,1990
341,1996-06-21,The Hunchback of Notre Dame,100000000,325500000,100138851,1996,225500000,225.5,1990
4009,1996-06-21,Lone Star,5000000,12961389,12961389,1996,7961389,159.22778,1990
913,1996-06-28,The Nutty Professor,55000000,273814019,128814019,1996,218814019,397.8436709090909,1990
1074,1996-06-28,Striptease,50000000,113309743,33109743,1996,63309743,126.619486,1990
583,1996-07-06,The Rock,75000000,336069511,134069511,1996,261069511,348.0926813333333,1990
1214,1996-07-06,The Phantom,45000000,17220599,17220599,1996,-27779401,-61.73200222222223,1990
1211,1996-07-17,Multiplicity,45000000,20133326,20133326,1996,-24866674,-55.259275555555554,1990
4875,1996-07-17,Walking and Talking,1000000,1615787,1287480,1996,615787,61.5787,1990
1818,1996-07-19,Fled,30000000,19892205,17192205,1996,-10107795,-33.69265,1990
4328,1996-07-19,Trainspotting,3100000,71558971,16501785,1996,68458971,2208.3539032258063,1990
1288,1996-07-24,A Time to Kill,40000000,152266007,108766007,1996,112266007,280.66501750000003,1990
2083,1996-07-26,Kingpin,25000000,32223424,25023424,1996,7223424,28.893696000000002,1990
2103,1996-07-26,The Adventures of Pinocchio,25000000,36682170,15382170,1996,11682170,46.72868,1990
4595,1996-07-26,Stonewall,2000000,304602,304602,1996,-1695398,-84.76989999999999,1990
3724,1996-08-03,Fargo,7000000,51204567,24567751,1996,44204567,631.4938142857143,1990
641,1996-08-11,Ransom,70000000,308700000,136492681,1996,238700000,341.0,1990
957,1996-08-16,The Fan,55000000,18582965,18582965,1996,-36417035,-66.21279090909091,1990
1188,1996-08-16,Tin Cup,45000000,75854588,53854588,1996,30854588,68.56575111111111,1990
2554,1996-08-16,Kansas City,19000000,1353824,1353824,1996,-17646176,-92.87461052631579,1990
1377,1996-08-23,The Island of Dr. Moreau,40000000,27682712,27682712,1996,-12317288,-30.793219999999998,1990
4278,1996-08-23,She's the One,3500000,13795053,9482579,1996,10295053,294.1443714285714,1990
4399,1996-08-23,Freeway,3000000,295493,295493,1996,-2704507,-90.15023333333333,1990
726,1996-09-02,Broken Arrow,65000000,148345997,70645997,1996,83345997,128.22461076923076,1990
1088,1996-09-08,Escape from L.A.,50000000,25426861,25426861,1996,-24573139,-49.146277999999995,1990
1185,1996-09-08,Jack,45000000,58617334,58617334,1996,13617334,30.26074222222222,1990
4386,1996-09-08,Basquiat,3000000,2962051,2962051,1996,-37949,-1.2649666666666666,1990
2110,1996-09-13,Maximum Risk,25000000,51702929,14102929,1996,26702929,106.81171599999999,1990
701,1996-09-20,Last Man Standing,67000000,18115927,18115927,1996,-48884073,-72.96130298507462,1990
1720,1996-09-20,The First Wives Club,30000000,181489203,105489203,1996,151489203,504.96401000000003,1990
5160,1996-09-20,When The Cat's Away,300000,2525984,1652472,1996,2225984,741.9946666666666,1990
1465,1996-09-27,Extreme Measures,38000000,17378193,17378193,1996,-20621807,-54.26791315789473,1990
4117,1996-09-28,Secrets & Lies,4500000,13417292,13417292,1996,8917292,198.16204444444446,1990
434,1996-10-05,Twister,88000000,495700000,241688385,1996,407700000,463.2954545454545,1990
4981,1996-10-05,Welcome to the Dollhouse,800000,5034794,4198137,1996,4234794,529.34925,1990
3054,1996-10-07,Harriet the Spy,13000000,26570048,26570048,1996,13570048,104.38498461538461,1990
4509,1996-10-16,Get on the Bus,2400000,5691854,5691854,1996,3291854,137.16058333333334,1990
1234,1996-10-18,Sleepers,44000000,165600852,53300852,1996,121600852,276.3655727272727,1990
5231,1996-10-18,Swingers,200000,6618578,4505922,1996,6418578,3209.2889999999998,1990
2986,1996-10-25,Thinner,14000000,15171475,15171475,1996,1171475,8.367678571428572,1990
742,1996-11-10,The Long Kiss Goodnight,65000000,33447612,33447612,1996,-31552388,-48.542135384615385,1990
946,1996-11-10,The Ghost and the Darkness,55000000,38564422,38564422,1996,-16435578,-29.882869090909093,1990
2122,1996-11-10,Michael Collins,25000000,27572844,11092559,1996,2572844,10.291376000000001,1990
4770,1996-11-10,Trees Lounge,1300000,749741,749741,1996,-550259,-42.327615384615385,1990
515,1996-11-15,Space Jam,80000000,250200000,90463534,1996,170200000,212.75,1990
1257,1996-11-15,The Mirror Has Two Faces,42000000,41267469,41267469,1996,-732531,-1.7441214285714286,1990
1525,1996-11-15,The English Patient,35000000,231711151,78716374,1996,196711151,562.03186,1990
4096,1996-11-20,Sling Blade,4833610,34175000,24475416,1996,29341390,607.0284942310199,1990
814,1996-11-22,Jingle All the Way,60000000,129832389,60592389,1996,69832389,116.38731499999999,1990
1154,1996-11-22,Star Trek: First Contact,46000000,150000000,92027888,1996,104000000,226.08695652173913,1990
3924,1996-11-22,Shine,5500000,36665191,35811509,1996,31165191,566.6398363636364,1990
2385,1996-12-01,Eye for an Eye,20000000,26792700,26792700,1996,6792700,33.9635,1990
1157,1996-12-07,Courage Under Fire,46000000,100833145,59003384,1996,54833145,119.20248913043478,1990
3766,1996-12-07,Les Visiteurs,7000000,98754000,659000,1996,91754000,1310.7714285714285,1990
537,1996-12-13,Mars Attacks!,80000000,101371017,37771017,1996,21371017,26.71377125,1990
1006,1996-12-13,Jerry Maguire,50000000,274000000,153952592,1996,224000000,448.00000000000006,1990
1501,1996-12-20,Ghosts of Mississippi,36000000,13052741,13052741,1996,-22947259,-63.74238611111112,1990
2215,1996-12-20,Marvin's Room,23000000,12803305,12803305,1996,-10196695,-44.33345652173913,1990
2282,1996-12-20,My Fellow Americans,21500000,22331846,22331846,1996,831846,3.869051162790697,1990
2796,1996-12-20,Scream,15000000,173046663,103046663,1996,158046663,1053.64442,1990
3135,1996-12-20,Beavis and Butt-head Do America,12000000,63118386,63118386,1996,51118386,425.98655,1990
942,1996-12-25,Evita,55000000,151947179,50047179,1996,96947179,176.2675981818182,1990
2631,1996-12-25,Hamlet,18000000,7129670,4501094,1996,-10870330,-60.39072222222222,1990
2934,1996-12-31,Silent Trigger,15000000,76382,76382,1996,-14923618,-99.49078666666666,1990
395,1997-01-07,Men in Black,90000000,587790539,250690539,1997,497790539,553.1005988888888,1990
4340,1997-01-08,Air Bud,3000000,27788649,24646936,1997,24788649,826.2883,1990
4057,1997-01-17,Albino Alligator,5000000,353480,353480,1997,-4646520,-92.9304,1990
3647,1997-01-24,Prefontaine,8000000,590817,590817,1997,-7409183,-92.61478749999999,1990
1229,1997-01-31,Shadow Conspiracy,45000000,2154540,2154540,1997,-42845460,-95.21213333333334,1990
4201,1997-01-31,Waiting for Guffman,4000000,2922988,2922988,1997,-1077012,-26.925300000000004,1990
1495,1997-02-05,Breakdown,36000000,50159144,50159144,1997,14159144,39.330955555555555,1990
1617,1997-02-05,Warriors of Virtue,35000000,6448817,6448817,1997,-28551183,-81.57480857142858,1990
2579,1997-02-05,Austin Powers: International Man of Mystery,18000000,67683989,53883989,1997,49683989,276.02216111111113,1990
1050,1997-02-14,Absolute Power,50000000,50068310,50068310,1997,68310,0.13662,1990
1997,1997-02-21,Blood and Wine,26000000,1083350,1083350,1997,-24916650,-95.83326923076923,1990
1548,1997-02-28,Donnie Brasco,35000000,65303052,41954997,1997,30303052,86.58014857142857,1990
1622,1997-02-28,Smilla's Sense of Snow,35000000,2221994,2221994,1997,-32778006,-93.65144571428571,1990
4376,1997-02-28,Kama Sutra,3000000,4109095,4109095,1997,1109095,36.969833333333334,1990
1940,1997-03-10,Kiss the Girls,27000000,60527873,60527873,1997,33527873,124.1773074074074,1990
3381,1997-03-14,Love Jones,10000000,12554569,12554569,1997,2554569,25.54569,1990
1159,1997-03-21,Liar Liar,45000000,302710615,181410615,1997,257710615,572.6902555555555,1990
2363,1997-03-21,Selena,20000000,35450113,35450113,1997,15450113,77.25056500000001,1990
428,1997-03-26,The Devil's Own,90000000,140900000,42885593,1997,50900000,56.55555555555556,1990
1687,1997-03-26,Cats Don't Dance,32000000,3588602,3588602,1997,-28411398,-88.78561875,1990
5194,1997-03-28,Love and Other Catastrophes,250000,743216,212285,1997,493216,197.2864,1990
423,1997-04-04,The Saint,90000000,169400000,61363304,1997,79400000,88.22222222222223,1990
5186,1997-04-04,Chasing Amy,250000,15155095,12006514,1997,14905095,5962.038,1990
1268,1997-04-18,McHale's Navy,42000000,4408420,4408420,1997,-37591580,-89.5037619047619,1990
4381,1997-04-18,8 Heads in a Duffel Bag,3000000,4002884,3602884,1997,1002884,33.42946666666667,1990
427,1997-04-25,Volcano,90000000,120100000,47546796,1997,30100000,33.44444444444444,1990
5166,1997-05-03,The Watermelon Woman,300000,42735,42735,1997,-257265,-85.75500000000001,1990
3303,1997-05-12,Good Will Hunting,10000000,225933435,138433435,1997,215933435,2159.33435,1990
576,1997-05-22,The Lost World: Jurassic Park,75000000,618638999,229086679,1997,543638999,724.8519986666666,1990
509,1997-06-06,Con Air,80000000,224117573,101117573,1997,144117573,180.14696625,1990
3173,1997-06-08,Def Jam's How To Be a Player,12000000,14010363,14010363,1997,2010363,16.753025,1990
304,1997-06-13,Speed 2: Cruise Control,110000000,150468000,48097081,1997,40468000,36.78909090909091,1990
648,1997-06-13,Hercules,70000000,250700000,99112101,1997,180700000,258.14285714285717,1990
4450,1997-06-13,Ulee's Gold,2700000,15600000,9054736,1997,12900000,477.77777777777777,1990
248,1997-06-20,Batman & Robin,125000000,238317814,107325195,1997,113317814,90.6542512,1990
1152,1997-06-20,My Best Friend's Wedding,46000000,298923419,126813153,1997,252923419,549.8335195652173,1990
4231,1997-06-20,The Last Time I Committed Suicide,4000000,12836,12836,1997,-3987164,-99.6791,1990
4888,1997-06-20,Dream With The Fishes,1000000,542909,542909,1997,-457091,-45.7091,1990
503,1997-06-27,Face/Off,80000000,241200000,112276146,1997,161200000,201.5,1990
277,1997-07-02,Dante's Peak,115000000,178200000,67163857,1997,63200000,54.95652173913044,1990
353,1997-07-11,Starship Troopers,100000000,121100000,54768952,1997,21100000,21.099999999999998,1990
1106,1997-07-11,Mad City,50000000,10561038,10561038,1997,-39438962,-78.877924,1990
4000,1997-07-11,Eve's Bayou,5000000,14843425,14843425,1997,9843425,196.8685,1990
916,1997-07-16,George Of The Jungle,55000000,174463257,105263257,1997,119463257,217.20592181818182,1990
2049,1997-07-18,Nothing To Lose,25000000,64594061,44480039,1997,39594061,158.376244,1990
443,1997-07-25,Air Force One,85000000,315268353,172956409,1997,230268353,270.90394470588234,1990
1330,1997-07-31,Spawn,40000000,87949859,54979992,1997,47949859,119.87464750000001,1990
520,1997-08-08,Conspiracy Theory,80000000,142783718,76118990,1997,62783718,78.4796475,1990
669,1997-08-10,Seven Years in Tibet,70000000,131445884,37945884,1997,61445884,87.77983428571429,1990
4266,1997-08-13,The Full Monty,3500000,257938649,45950122,1997,254438649,7269.6756857142855,1990
859,1997-08-15,Event Horizon,60000000,26673242,26673242,1997,-33326758,-55.54459666666667,1990
2769,1997-08-15,Steel,16000000,1686429,1686429,1997,-14313571,-89.45981875,1990
2817,1997-08-15,Cop Land,15000000,63706632,44906632,1997,48706632,324.71088,1990
1053,1997-08-22,G.I. Jane,50000000,48169156,48169156,1997,-1830844,-3.661688,1990
2053,1997-08-22,Money Talks,25000000,41076865,41076865,1997,16076865,64.30746,1990
5113,1997-08-22,Sunday,450000,450349,410919,1997,349,0.07755555555555556,1990
1999,1997-08-24,The Grimm Brothers' Snow White,26000000,5000,5000,1997,-25995000,-99.98076923076923,1990
377,1997-09-05,The Fifth Element,95000000,263900000,63570862,1997,168900000,177.78947368421052,1990
474,1997-09-05,Father's Day,85000000,35681080,28681080,1997,-49318920,-58.02225882352941,1990
1529,1997-09-19,L.A. Confidential,35000000,126204977,64604977,1997,91204977,260.5856485714286,1990
1531,1997-09-19,In & Out,35000000,83226569,63826569,1997,48226569,137.79019714285715,1990
1062,1997-09-26,The Peacemaker,50000000,62967368,41263140,1997,12967368,25.934736,1990
2620,1997-09-26,The Ice Storm,18000000,16011975,8038061,1997,-1988025,-11.044583333333332,1990
3678,1997-09-26,Soul Food,7500000,43492389,43492389,1997,35992389,479.89851999999996,1990
848,1997-10-01,The Relic,60000000,33956608,33956608,1997,-26043392,-43.40565333333333,1990
961,1997-10-01,Turbulence,55000000,11532774,11532774,1997,-43467226,-79.03132000000001,1990
2850,1997-10-10,Boogie Nights,15000000,43111725,26410771,1997,28111725,187.4115,1990
4038,1997-10-10,The Sweet Hereafter,5000000,7951247,4306697,1997,2951247,59.02494,1990
897,1997-10-17,Devil's Advocate,57000000,153007424,61007424,1997,96007424,168.43407719298244,1990
2669,1997-10-17,I Know What You Did Last Summer,17000000,125250091,72250091,1997,108250091,636.7652411764706,1990
1502,1997-10-24,Gattaca,36000000,12532777,12532777,1997,-23467223,-65.18673055555556,1990
1470,1997-10-31,Switchback,38000000,6504442,6504442,1997,-31495558,-82.88304736842105,1990
3214,1997-10-31,Critical Care,12000000,220175,220175,1997,-11779825,-98.16520833333333,1990
1181,1997-11-04,Anaconda,45000000,136998907,65598907,1997,91998907,204.44201555555557,1990
2847,1997-11-04,Grosse Pointe Blank,15000000,31070412,28084357,1997,16070412,107.13607999999999,1990
5372,1997-11-04,Pink Flamingos,12000,413802,413802,1997,401802,3348.35,1990
407,1997-11-07,Contact,90000000,165900000,100920329,1997,75900000,84.33333333333334,1990
1923,1997-11-07,A Simple Wish,28000000,8165213,8165213,1997,-19834787,-70.83852499999999,1990
821,1997-11-14,The Jackal,60000000,159356941,54956941,1997,99356941,165.59490166666666,1990
980,1997-11-14,Anastasia,53000000,139801290,58403409,1997,86801290,163.77601886792453,1990
2432,1997-11-14,The Man Who Knew Too Little,20000000,13801755,13801755,1997,-6198245,-30.991225,1990
1345,1997-11-21,The Rainmaker,40000000,45916769,45916769,1997,5916769,14.791922499999998,1990
1578,1997-11-21,Midnight in the Garden of Good and Evil,35000000,25078937,25078937,1997,-9921063,-28.345894285714284,1990
1785,1997-11-21,Mortal Kombat: Annihilation,30000000,51327406,35927406,1997,21327406,71.09135333333333,1990
513,1997-11-26,Flubber,80000000,177993801,92993801,1997,97993801,122.49225125000001,1990
830,1997-11-26,Alien: Resurrection,60000000,160700000,47795018,1997,100700000,167.83333333333331,1990
1052,1997-12-09,The Game,50000000,80369970,48265581,1997,30369970,60.739940000000004,1990
1347,1997-12-12,Amistad,40000000,58250151,44212592,1997,18250151,45.6253775,1990
2165,1997-12-12,Scream 2,24000000,101363301,101363301,1997,77363301,322.3470875,1990
2449,1997-12-12,Deconstructing Harry,20000000,10686841,10686841,1997,-9313159,-46.565795,1990
3987,1997-12-17,The Apostle,5000000,21277770,20733485,1997,16277770,325.5554,1990
37,1997-12-19,Titanic,200000000,2207615668,658672302,1997,2007615668,1003.8078340000001,1990
290,1997-12-19,Tomorrow Never Dies,110000000,339504276,125304276,1997,229504276,208.6402509090909,1990
1451,1997-12-19,Mouse Hunt,38000000,61894591,61894591,1997,23894591,62.88050263157895,1990
1008,1997-12-24,As Good as it Gets,50000000,314111923,148478011,1997,264111923,528.223846,1990
550,1997-12-25,The Postman,80000000,20841123,17650704,1997,-59158877,-73.94859625,1990
1925,1997-12-25,Kundun,28000000,5686694,5686694,1997,-22313306,-79.69037857142857,1990
2818,1997-12-25,Wag the Dog,15000000,64252038,43057470,1997,49252038,328.34692,1990
3139,1997-12-25,Jackie Brown,12000000,74727492,39673162,1997,62727492,522.7291,1990
3112,1997-12-31,Oscar and Lucinda,12500000,1612957,1612957,1997,-10887043,-87.096344,1990
2090,1998-01-05,He Got Game,25000000,22411948,21567853,1998,-2588052,-10.352208000000001,1990
4216,1998-01-05,Shooting Fish,4000000,302204,302204,1998,-3697796,-92.44489999999999,1990
4518,1998-01-05,"Dancer, Texas Pop. 81",2300000,574838,574838,1998,-1725162,-75.00704347826087,1990
182,1998-01-07,Armageddon,140000000,554600000,201578182,1998,414600000,296.1428571428571,1990
677,1998-01-16,Hard Rain,70000000,19870567,19870567,1998,-50129433,-71.61347571428571,1990
3621,1998-01-16,Half Baked,8000000,17394881,17394881,1998,9394881,117.4360125,1990
4456,1998-01-16,The Dress,2650000,16556,16556,1998,-2633444,-99.37524528301887,1990
2077,1998-01-23,Spice World,25000000,56042592,29342592,1998,31042592,124.17036800000001,1990
1222,1998-01-30,Deep Rising,45000000,11203026,11203026,1998,-33796974,-75.10438666666667,1990
4048,1998-01-30,Zero Effect,5000000,2080693,2080693,1998,-2919307,-58.38614,1990
530,1998-02-10,What Dreams May Come,80000000,71485043,55485043,1998,-8514957,-10.64369625,1990
792,1998-02-10,Antz,60000000,152457863,90757863,1998,92457863,154.09643833333334,1990
2685,1998-02-10,A Night at the Roxbury,17000000,30331165,30331165,1998,13331165,78.41861764705882,1990
621,1998-02-13,Sphere,73000000,50168294,37068294,1998,-22831706,-31.276309589041094,1990
1871,1998-02-13,The Borrowers,29000000,54045832,22619589,1998,25045832,86.36493793103448,1990
5065,1998-02-13,Hurricane Streets,500000,367582,334041,1998,-132418,-26.483600000000003,1990
5321,1998-02-20,I Love You … Don't Touch Me!,68000,33598,33598,1998,-34402,-50.59117647058824,1990
1951,1998-02-27,Dark City,27000000,27257061,14435076,1998,257061,0.9520777777777777,1990
3468,1998-02-27,An Alan Smithee Film: Burn Hollywood Burn,10000000,45779,45779,1998,-9954221,-99.54221,1990
524,1998-03-04,Lost In Space,80000000,136047317,69117629,1998,56047317,70.05914625,1990
849,1998-03-04,Mercury Rising,60000000,32983332,32983332,1998,-27016668,-45.02778,1990
2885,1998-03-04,Barney's Great Adventure,15000000,11156471,11156471,1998,-3843529,-25.623526666666667,1990
3387,1998-03-04,The Spanish Prisoner,10000000,13835130,10162034,1998,3835130,38.3513,1990
1537,1998-03-13,The Man in the Iron Mask,35000000,56968169,56968169,1998,21968169,62.76619714285714,1990
3771,1998-03-13,Chairman of the Board,7000000,306715,306715,1998,-6693285,-95.61835714285715,1990
739,1998-03-20,Primary Colors,65000000,39017984,39017984,1998,-25982016,-39.97233230769231,1990
2380,1998-03-20,Wild Things,20000000,55576699,29795299,1998,35576699,177.883495,1990
3234,1998-03-20,Madadayo,11900000,48856,48856,1998,-11851144,-99.58944537815127,1990
3852,1998-03-20,Mr. Nice Guy,6000000,31716953,12716953,1998,25716953,428.61588333333333,1990
1956,1998-03-27,The Newton Boys,27000000,10341093,10341093,1998,-16658907,-61.69965555555555,1990
2192,1998-03-27,Meet the Deedles,24000000,4356126,4356126,1998,-19643874,-81.849475,1990
2507,1998-03-27,"Couloirs du temps: Les visiteurs 2, Les",20000000,26146072,146072,1998,6146072,30.73036,1990
4062,1998-03-27,No Looking Back,5000000,143273,143273,1998,-4856727,-97.13454,1990
4128,1998-03-27,Karakter,4500000,713413,713413,1998,-3786587,-84.14637777777779,1990
1606,1998-04-09,Knock Off,35000000,10319915,10319915,1998,-24680085,-70.51452857142857,1990
2398,1998-04-12,Psycho,20000000,37226218,21541218,1998,17226218,86.13109,1990
3868,1998-04-12,Little Voice,6000000,21787233,4595000,1998,15787233,263.12055,1990
4602,1998-04-15,24 7: Twenty Four Seven,2000000,72544,72544,1998,-1927456,-96.3728,1990
2845,1998-04-17,The Object of my Affection,15000000,29145924,29145924,1998,14145924,94.30616,1990
3052,1998-04-24,The Big Hit,13000000,27066941,27066941,1998,14066941,108.20723846153845,1990
3854,1998-04-24,Sliding Doors,6000000,58809149,11911200,1998,52809149,880.1524833333334,1990
4871,1998-04-24,Two Girls and a Guy,1000000,2315026,2057193,1998,1315026,131.5026,1990
780,1998-05-06,The Truman Show,60000000,264118201,125618201,1998,204118201,340.19700166666667,1990
2675,1998-05-08,Halloween: H2O,17000000,55041738,55041738,1998,38041738,223.7749294117647,1990
804,1998-05-15,The Horse Whisperer,60000000,186883563,75383563,1998,126883563,211.472605,1990
1386,1998-05-15,Quest for Camelot,40000000,38172500,22772500,1998,-1827500,-4.56875,1990
1799,1998-05-15,Bulworth,30000000,29203383,26528684,1998,-796617,-2.6553899999999997,1990
4591,1998-05-15,Clockwatchers,2000000,539961,537948,1998,-1460039,-73.00195000000001,1990
245,1998-05-19,Godzilla,125000000,376000000,136314294,1998,251000000,200.8,1990
2561,1998-05-22,Fear and Loathing in Las Vegas,18500000,13711903,10680275,1998,-4788097,-25.881605405405406,1990
4277,1998-05-27,I Got the Hook-Up!,3500000,10317779,10317779,1998,6817779,194.79368571428571,1990
1746,1998-05-29,Hope Floats,30000000,81529000,60110313,1998,51529000,171.76333333333332,1990
1811,1998-06-02,The Replacement Killers,30000000,19035741,19035741,1998,-10964259,-36.54753,1990
2427,1998-06-03,Twilight,20000000,15055091,15055091,1998,-4944909,-24.724545,1990
2866,1998-06-03,The Big Lebowski,15000000,46189568,17498804,1998,31189568,207.93045333333336,1990
4160,1998-06-03,Love and Death on Long Island,4030000,2542264,2542264,1998,-1487736,-36.91652605459057,1990
666,1998-06-11,The Siege,70000000,116625798,40934175,1998,46625798,66.60828285714285,1990
2075,1998-06-11,Elizabeth,25000000,82150642,30082699,1998,57150642,228.602568,1990
2197,1998-06-11,The Waterboy,23000000,190191646,161491646,1998,167191646,726.9202,1990
3545,1998-06-11,Velvet Goldmine,9000000,4313644,1053788,1998,-4686356,-52.07062222222222,1990
4280,1998-06-11,Gods and Monsters,3500000,6451628,6451628,1998,2951628,84.33222857142857,1990
404,1998-06-19,Mulan,90000000,303500000,120620254,1998,213500000,237.22222222222223,1990
704,1998-06-19,The X Files: Fight the Future,66000000,189176423,83898313,1998,123176423,186.63094393939394,1990
5019,1998-06-19,Hav Plenty,650000,2301777,2301777,1998,1651777,254.11953846153844,1990
633,1998-06-26,Doctor Dolittle,71500000,294156605,144156605,1998,222656605,311.40783916083916,1990
1138,1998-06-26,Out of Sight,48000000,77562568,37562568,1998,29562568,61.588683333333336,1990
4561,1998-06-26,Smoke Signals,2000000,7756617,6719300,1998,5756617,287.83085,1990
4721,1998-06-26,Buffalo '66,1500000,2380606,2380606,1998,880606,58.70706666666666,1990
620,1998-07-08,Snake Eyes,73000000,103891409,55591409,1998,30891409,42.316998630136986,1990
4910,1998-07-08,Safe Men,1000000,21210,21210,1998,-978790,-97.879,1990
5171,1998-07-08,"First Love, Last Rites",300000,10876,10876,1998,-289124,-96.37466666666667,1990
2232,1998-07-15,There's Something About Mary,22000000,360099999,176484651,1998,338099999,1536.8181772727273,1990
721,1998-07-17,The Mask of Zorro,65000000,233700000,93828745,1998,168700000,259.53846153846155,1990
967,1998-07-22,Lolita,55000000,1147784,1147784,1998,-53852216,-97.91311999999999,1990
706,1998-07-24,Saving Private Ryan,65000000,485035085,216335085,1998,420035085,646.2078230769231,1990
2865,1998-07-24,Disturbing Behavior,15000000,19014238,17507368,1998,4014238,26.761586666666666,1990
3361,1998-07-24,Jane Austen's Mafia,10000000,30143795,19843795,1998,20143795,201.43795,1990
1058,1998-07-29,The Negotiator,50000000,49105766,44705766,1998,-894234,-1.788468,1990
1973,1998-07-31,Ever After: A Cinderella Story,26000000,65705772,65705772,1998,39705772,152.7145076923077,1990
3982,1998-08-04,The Players Club,5000000,23047939,23047939,1998,18047939,360.95878,1990
495,1998-08-05,Deep Impact,80000000,349464664,140464664,1998,269464664,336.83083,1990
3070,1998-08-05,Woo,13000000,8064972,8064972,1998,-4935028,-37.96175384615385,1990
862,1998-08-14,The Avengers,60000000,48585416,23385416,1998,-11414584,-19.024306666666664,1990
2356,1998-08-14,How Stella Got Her Groove Back,20000000,37672944,37672944,1998,17672944,88.36471999999999,1990
3451,1998-08-14,La femme de chambre du Titanic,10000000,244465,244465,1998,-9755535,-97.55534999999999,1990
4031,1998-08-14,Slums of Beverly Hills,5000000,5502773,5502773,1998,502773,10.05546,1990
1177,1998-08-21,Blade,45000000,131237688,70141876,1998,86237688,191.63930666666667,1990
2987,1998-08-21,Dead Man on Campus,14000000,15064948,15064948,1998,1064948,7.606771428571428,1990
4865,1998-08-21,"Next Stop, Wonderland",1000000,3465703,3395581,1998,2465703,246.5703,1990
3064,1998-08-28,54,13000000,16757163,16757163,1998,3757163,28.901253846153846,1990
5195,1998-08-28,I Married a Strange Person,250000,203134,203134,1998,-46866,-18.746399999999998,1990
2549,1998-09-01,Firestorm,19000000,8123860,8123860,1998,-10876140,-57.24284210526316,1990
871,1998-09-10,Holy Man,60000000,12069719,12069719,1998,-47930281,-79.88380166666667,1990
4769,1998-09-10,Festen,1300000,1647780,1647780,1998,347780,26.752307692307692,1990
4878,1998-09-10,Slam,1000000,1087521,1009819,1998,87521,8.7521,1990
5300,1998-09-10,The Mighty,100000,6121582,2652246,1998,6021582,6021.582,1990
1514,1998-09-18,Rush Hour,35000000,245300000,141186864,1998,210300000,600.8571428571429,1990
1802,1998-09-18,One True Thing,30000000,26708196,23337196,1998,-3291804,-10.97268,1990
4598,1998-09-18,Six-String Samurai,2000000,134624,134624,1998,-1865376,-93.2688,1990
944,1998-09-25,Ronin,55000000,70692101,41610884,1998,15692101,28.53109272727273,1990
2970,1998-09-25,Urban Legend,14000000,72571864,38116707,1998,58571864,418.37045714285716,1990
3643,1998-09-25,Clay Pigeons,8000000,2256606,1793359,1998,-5743394,-71.79242500000001,1990
4909,1998-09-25,The Last Big Thing,1000000,22434,22434,1998,-977566,-97.7566,1990
925,1998-10-04,City of Angels,55000000,198750909,78750909,1998,143750909,261.36528909090913,1990
186,1998-10-07,Lethal Weapon 4,140000000,285400000,130444603,1998,145400000,103.85714285714285,1990
1329,1998-10-07,Small Soldiers,40000000,71743823,55143823,1998,31743823,79.3595575,1990
5320,1998-10-07,Pi,68000,4678513,3221152,1998,4610513,6780.166176470589,1990
832,1998-10-16,Practical Magic,60000000,68336997,46850558,1998,8336997,13.894994999999998,1990
985,1998-10-16,Beloved,53000000,22852487,22852487,1998,-30147513,-56.8821,1990
2070,1998-10-16,Bride of Chucky,25000000,50692188,32404188,1998,25692188,102.76875199999999,1990
4389,1998-10-16,Happiness,3000000,5746453,2746453,1998,2746453,91.54843333333334,1990
612,1998-10-23,Soldier,75000000,14623082,14623082,1998,-60376918,-80.50255733333333,1990
4884,1998-10-23,Orgazmo,1000000,627287,582024,1998,-372713,-37.271300000000004,1990
2402,1998-10-30,Vampires,20000000,20268825,20268825,1998,268825,1.344125,1990
3175,1998-10-30,Living Out Loud,12000000,12905901,12905901,1998,905901,7.549175,1990
3404,1998-10-30,American History X,10000000,6719864,6719864,1998,-3280136,-32.80136,1990
2149,1998-11-09,Without Limits,25000000,780326,780326,1998,-24219674,-96.87869599999999,1990
2412,1998-11-09,Simon Birch,20000000,18310591,18253415,1998,-1689409,-8.447045000000001,1990
3158,1998-11-09,Rounders,12000000,22921898,22921898,1998,10921898,91.01581666666667,1990
5162,1998-11-09,Let's Talk About Sex,300000,373615,373615,1998,73615,24.538333333333334,1990
5193,1998-11-09,Cube,250000,8969065,489220,1998,8719065,3487.626,1990
656,1998-11-12,Star Trek: Insurrection,70000000,117800000,70187658,1998,47800000,68.28571428571428,1990
1072,1998-11-12,Jack Frost,50000000,34645374,34645374,1998,-15354626,-30.709252,1990
1969,1998-11-12,Shakespeare in Love,26000000,279500000,100317794,1998,253500000,975.0,1990
2693,1998-11-12,A Simple Plan,17000000,16316273,16316273,1998,-683727,-4.021923529411764,1990
3367,1998-11-12,Rushmore,10000000,19080435,17105219,1998,9080435,90.80435,1990
467,1998-11-13,Meet Joe Black,85000000,44650003,44650003,1998,-40349997,-47.47058470588235,1990
2174,1998-11-13,I Still Know What You Did Last Summer,24000000,40020622,40020622,1998,16020622,66.75259166666667,1990
453,1998-11-20,Enemy of the State,85000000,250649836,111549836,1998,165649836,194.88216,1990
1160,1998-11-20,A Bug's Life,45000000,363095319,162798565,1998,318095319,706.8784866666666,1990
1884,1998-11-20,The Rugrats Movie,28000000,140894685,100494685,1998,112894685,403.19530357142855,1990
3191,1998-11-20,Celebrity,12000000,6200000,5078660,1998,-5800000,-48.333333333333336,1990
4339,1998-11-20,Waking Ned Devine,3000000,55193251,24793251,1998,52193251,1739.7750333333333,1990
4435,1998-11-20,Central do Brasil,2900000,17006158,5969553,1998,14106158,486.4192413793104,1990
549,1998-11-25,Babe: Pig in the City,80000000,69131860,18319860,1998,-10868140,-13.585175,1990
2887,1998-11-25,Home Fries,15000000,10513979,10513979,1998,-4486021,-29.906806666666668,1990
3389,1998-11-25,Very Bad Things,10000000,21094974,9949470,1998,11094974,110.94973999999999,1990
521,1998-12-06,"Six Days, Seven Nights",80000000,164800000,74339294,1998,84800000,106.0,1990
3069,1998-12-06,Dirty Work,13000000,10020081,10020081,1998,-2979919,-22.922453846153847,1990
3351,1998-12-06,Can't Hardly Wait,10000000,25358996,25358996,1998,15358996,153.58996,1990
3654,1998-12-06,The Land Girls,8000000,146083,146083,1998,-7853917,-98.1739625,1990
715,1998-12-18,You've Got Mail,65000000,250800000,115821495,1998,185800000,285.84615384615387,1990
788,1998-12-18,The Prince of Egypt,60000000,218613188,101413188,1998,158613188,264.35531333333336,1990
993,1998-12-23,The Thin Red Line,52000000,97709034,36400491,1998,45709034,87.90198846153847,1990
531,1998-12-25,Mighty Joe Young,80000000,50632037,50632037,1998,-29367963,-36.709953750000004,1990
818,1998-12-25,A Civil Action,60000000,56709981,56709981,1998,-3290019,-5.483365,1990
1009,1998-12-25,Patch Adams,50000000,202173000,135014968,1998,152173000,304.346,1990
1020,1998-12-25,Stepmom,50000000,159745279,91137662,1998,109745279,219.490558,1990
2823,1998-12-25,The Faculty,15000000,40283321,40283321,1998,25283321,168.55547333333334,1990
3450,1998-12-25,The Swindle,10000000,5045359,245359,1998,-4954641,-49.54641,1990
1638,1999-01-09,Chill Factor,34000000,11263966,11263966,1999,-22736034,-66.87068823529412,1990
3745,1999-01-09,Outside Providence,7000000,7824358,7309628,1999,824358,11.776542857142857,1990
1131,1999-01-10,Three Kings,48000000,107752036,60652036,1999,59752036,124.48340833333333,1990
1921,1999-01-10,"Mystery, Alaska",28000000,8891623,8891623,1999,-19108377,-68.24420357142857,1990
2696,1999-01-10,The Adventures of Elmo in Grouchland,17000000,11634458,11634458,1999,-5365542,-31.562011764705883,1990
3619,1999-01-10,Drive Me Crazy,8000000,22591451,17843379,1999,14591451,182.3931375,1990
4689,1999-01-10,"Happy, Texas",1700000,2891228,2039192,1999,1191228,70.07223529411765,1990
613,1999-01-15,Virus,75000000,30626690,14010690,1999,-44373310,-59.16441333333333,1990
1388,1999-01-15,At First Sight,40000000,22365133,22365133,1999,-17634867,-44.0871675,1990
1830,1999-01-15,In Dreams,30000000,12017369,12017369,1999,-17982631,-59.94210333333333,1990
2729,1999-01-15,Varsity Blues,16000000,54294169,52894169,1999,38294169,239.33855624999998,1990
4702,1999-01-15,Mississippi Mermaid,1600000,2627795,27795,1999,1027795,64.2371875,1990
1842,1999-01-22,Gloria,30000000,4967493,4167493,1999,-25032507,-83.44169000000001,1990
5259,1999-01-22,Bacheha-Ye aseman,180000,1628579,933933,1999,1448579,804.7661111111111,1990
3310,1999-01-29,She's All That,10000000,63465522,63465522,1999,53465522,534.65522,1990
1376,1999-02-04,The Out-of-Towners,40000000,28544120,28544120,1999,-11455880,-28.6397,1990
5387,1999-02-04,Following,6000,240495,48482,1999,234495,3908.2500000000005,1990
2258,1999-02-07,Summer of Sam,22000000,19288130,19288130,1999,-2711870,-12.326681818181818,1990
5033,1999-02-07,Broken Vessels,600000,85343,15030,1999,-514657,-85.77616666666667,1990
3385,1999-02-19,Office Space,10000000,12179708,10827813,1999,2179708,21.797079999999998,1990
4385,1999-02-19,Jawbreaker,3000000,3076820,3076820,1999,76820,2.5606666666666666,1990
1360,1999-02-26,8MM,40000000,96398826,36443442,1999,56398826,140.997065,1990
3861,1999-02-26,200 Cigarettes,6000000,6852450,6852450,1999,852450,14.207500000000001,1990
5322,1999-02-26,20 Dates,66000,602920,541636,1999,536920,813.5151515151515,1990
2218,1999-03-12,The End of the Affair,23000000,10660147,10660147,1999,-12339853,-53.6515347826087,1990
3202,1999-03-19,Ravenous,12000000,2062406,2062406,1999,-9937594,-82.81328333333333,1990
4919,1999-03-19,Sparkler,1000000,5494,5494,1999,-994506,-99.4506,1990
864,1999-03-26,EDtv,60000000,35319689,22508689,1999,-24680311,-41.133851666666665,1990
3001,1999-03-26,A Walk on the Moon,14000000,4741987,4741987,1999,-9258013,-66.1286642857143,1990
3990,1999-03-26,Doug's 1st Movie,5000000,19421271,19421271,1999,14421271,288.42542,1990
4226,1999-03-26,Among Giants,4000000,64359,64359,1999,-3935641,-98.391025,1990
711,1999-03-31,The Matrix,65000000,463517383,171479930,1999,398517383,613.1036661538461,1990
3048,1999-03-31,Ten Things I Hate About You,13000000,60414025,38177966,1999,47414025,364.72326923076923,1990
950,1999-04-06,Instinct,55000000,34105207,34105207,1999,-20894793,-37.99053272727273,1990
3589,1999-04-06,Limbo,8300000,2598224,2160710,1999,-5701776,-68.69609638554218,1990
4065,1999-04-06,Desert Blue,5000000,99147,99147,1999,-4900853,-98.01706,1990
1091,1999-04-08,The Iron Giant,50000000,31333917,23159305,1999,-18666083,-37.332166,1990
3072,1999-04-08,Dick,13000000,6276869,6276869,1999,-6723131,-51.7163923076923,1990
4409,1999-04-08,The Gambler,3000000,101773,51773,1999,-2898227,-96.60756666666667,1990
595,1999-04-16,Life,75000000,73521587,64062587,1999,-1478413,-1.9712173333333332,1990
1653,1999-04-23,Pushing Tin,33000000,8408835,8408835,1999,-24591165,-74.51868181818182,1990
2303,1999-04-23,eXistenZ,20700000,2840417,2840417,1999,-17859583,-86.27817874396135,1990
2997,1999-04-23,Lost and Found,14000000,6552255,6552255,1999,-7447745,-53.19817857142857,1990
3577,1999-04-23,Election,8500000,17202854,14943582,1999,8702854,102.38651764705881,1990
703,1999-04-30,Entrapment,66000000,211700000,87707396,1999,145700000,220.75757575757575,1990
2913,1999-04-30,Idle Hands,15000000,4023741,4023741,1999,-10976259,-73.17506,1990
4585,1999-04-30,Get Real,2000000,1152411,1152411,1999,-847589,-42.37945,1990
1025,1999-05-02,Payback,50000000,161626121,81526121,1999,111626121,223.252242,1990
3870,1999-05-02,Simply Irresistible,6000000,4398989,4398989,1999,-1601011,-26.68351666666667,1990
1719,1999-05-03,Analyze This,30000000,176885658,106885658,1999,146885658,489.61886000000004,1990
3253,1999-05-03,Cruel Intentions,11000000,75803716,38230075,1999,64803716,589.1246909090909,1990
4766,1999-05-03,"Lock, Stock and Two Smoking Barrels",1350000,28356188,3897569,1999,27006188,2000.4583703703706,1990
697,1999-05-11,The Insider,68000000,60265197,28965197,1999,-7734803,-11.374710294117648,1990
1130,1999-05-11,The Bone Collector,48000000,151463090,66488090,1999,103463090,215.54810416666666,1990
2295,1999-05-11,The Bachelor,21000000,36882378,21731001,1999,15882378,75.63037142857144,1990
2988,1999-05-14,Tea with Mussolini,14000000,14395874,14395874,1999,395874,2.8276714285714286,1990
272,1999-05-19,Star Wars Ep. I: The Phantom Menace,115000000,1027044677,474544677,1999,912044677,793.082327826087,1990
2900,1999-05-21,The Love Letter,15000000,8322608,8322608,1999,-6677392,-44.515946666666665,1990
5143,1999-05-21,Trekkies,375000,617172,617172,1999,242172,64.5792,1990
1248,1999-05-28,Notting Hill,42000000,363728226,116089678,1999,321728226,766.0195857142857,1990
2757,1999-05-28,The Thirteenth Floor,16000000,11810854,11810854,1999,-4189146,-26.1821625,1990
4212,1999-05-28,The Loss of Sexual Innocence,4000000,399793,399793,1999,-3600207,-90.00517500000001,1990
696,1999-06-08,Mystery Men,68000000,33462011,29762011,1999,-34537989,-50.791160294117645,1990
1129,1999-06-08,The Thomas Crown Affair,48000000,124304264,69304264,1999,76304264,158.96721666666667,1990
1276,1999-06-08,The Sixth Sense,40000000,672806292,293506292,1999,632806292,1582.01573,1990
3443,1999-06-08,Illuminata,10000000,836641,836641,1999,-9163359,-91.63359,1990
175,1999-06-16,Tarzan,145000000,448191819,171091819,1999,303191819,209.09780620689654,1990
787,1999-06-18,The General's Daughter,60000000,149705852,102705852,1999,89705852,149.50975333333335,1990
3291,1999-06-18,An Ideal Husband,10700000,31341183,18542974,1999,20641183,192.90825233644858,1990
4680,1999-06-18,Lola rennt,1750000,22879194,7267324,1999,21129194,1207.3825142857143,1990
1707,1999-06-25,Big Daddy,30000000,228641283,163479795,1999,198641283,662.13761,1990
90,1999-06-30,Wild Wild West,175000000,221229335,113805681,1999,46229335,26.416762857142857,1990
2285,1999-06-30,"South Park: Bigger, Longer & Uncut",21000000,52037603,52037603,1999,31037603,147.79810952380953,1990
492,1999-07-05,The Mummy,80000000,416385488,155385488,1999,336385488,420.48186000000004,1990
2185,1999-07-14,Muppets From Space,24000000,16304786,16304786,1999,-7695214,-32.06339166666667,1990
731,1999-07-16,Eyes Wide Shut,65000000,104267443,55691208,1999,39267443,60.41145076923077,1990
1947,1999-07-16,Lake Placid,27000000,31770413,31770413,1999,4770413,17.668196296296294,1990
3841,1999-07-16,The Wood,6000000,25059640,25059640,1999,19059640,317.66066666666666,1990
4227,1999-07-16,The Velocity of Gary,4000000,34145,34145,1999,-3965855,-99.14637499999999,1990
514,1999-07-23,The Haunting,80000000,180188905,91188905,1999,100188905,125.23613125,1990
588,1999-07-23,Inspector Gadget,75000000,97387965,97387965,1999,22387965,29.85062,1990
3386,1999-07-23,Drop Dead Gorgeous,10000000,10571408,10571408,1999,571408,5.71408,1990
807,1999-07-28,Deep Blue Sea,60000000,165048228,73648228,1999,105048228,175.08038,1990
639,1999-07-30,Runaway Bride,70000000,310138178,152257509,1999,240138178,343.05454000000003,1990
5062,1999-07-30,Twin Falls Idaho,500000,1027228,985341,1999,527228,105.44560000000001,1990
5204,1999-08-01,Sticky Fingers of Time,250000,20628,18195,1999,-229372,-91.7488,1990
756,1999-08-10,Random Hearts,64000000,63200000,31054924,1999,-800000,-1.25,1990
2975,1999-08-10,Superstar,14000000,30628981,30628981,1999,16628981,118.77843571428572,1990
3420,1999-08-10,The Limey,10000000,6030047,3193102,1999,-3969953,-39.69953,1990
4553,1999-08-10,Boys Don't Cry,2000000,20741000,11540607,1999,18741000,937.05,1990
5014,1999-08-10,Naturally Native,700000,10508,10508,1999,-689492,-98.49885714285715,1990
1688,1999-08-12,Cradle Will Rock,32000000,2899970,2899970,1999,-29100030,-90.93759375,1990
931,1999-08-13,Bowfinger,55000000,98699769,66458769,1999,43699769,79.45412545454545,1990
2127,1999-08-13,Brokedown Palace,25000000,11115766,10115014,1999,-13884234,-55.536936000000004,1990
2764,1999-08-13,Detroit Rock City,16000000,5825314,4217115,1999,-10174686,-63.591787499999995,1990
1363,1999-08-20,Mickey Blue Eyes,40000000,53864342,33864342,1999,13864342,34.660855,1990
1410,1999-08-20,Universal Soldier II: The Return,40000000,10717421,10447421,1999,-29282579,-73.20644750000001,1990
3735,1999-08-25,In Too Deep,7000000,15471229,14026509,1999,8471229,121.01755714285713,1990
252,1999-08-27,The 13th Warrior,125000000,61698899,32698899,1999,-63301101,-50.6408808,1990
1639,1999-08-27,The Astronaut's Wife,34000000,10672566,10672566,1999,-23327434,-68.6101,1990
2268,1999-08-27,Dudley Do-Right,22000000,9818792,9818792,1999,-12181208,-55.36912727272727,1990
2884,1999-08-27,The Muse,15000000,11614954,11614954,1999,-3385046,-22.566973333333333,1990
3755,1999-08-27,A Dog of Flanders,7000000,2165637,2165637,1999,-4834363,-69.06232857142857,1990
3912,1999-08-27,Stiff Upper Lips,5700000,69582,69582,1999,-5630418,-98.77926315789473,1990
3807,1999-09-04,Go!,6500000,28383441,16875273,1999,21883441,336.6683230769231,1990
4694,1999-09-04,Foolish,1600000,6026908,6026908,1999,4426908,276.68175,1990
2281,1999-09-07,Arlington Road,21500000,24419219,24419219,1999,2919219,13.577762790697676,1990
3123,1999-09-07,American Pie,12000000,234723148,101800948,1999,222723148,1856.0262333333335,1990
2793,1999-09-15,American Beauty,15000000,356258047,130058047,1999,341258047,2275.0536466666667,1990
1071,1999-09-17,For Love of the Game,50000000,46112640,35188640,1999,-3887360,-7.77472,1990
1492,1999-09-17,Blue Streak,36000000,117448157,68208190,1999,81448157,226.24488055555557,1990
3218,1999-09-17,Breakfast of Champions,12000000,178287,178287,1999,-11821713,-98.514275,1990
4293,1999-09-17,Taxman,3500000,9871,9871,1999,-3490129,-99.71797142857143,1990
5197,1999-09-17,Sugar Town,250000,178095,178095,1999,-71905,-28.762,1990
1286,1999-09-24,Double Jeopardy,40000000,177835231,116735231,1999,137835231,344.5880775,1990
1879,1999-09-24,Mumford,28700000,4559569,4559569,1999,-24140431,-84.113,1990
2645,1999-09-24,One Man's Hero,18000000,229311,229311,1999,-17770689,-98.72605,1990
2910,1999-09-24,Jakob the Liar,15000000,4956401,4956401,1999,-10043599,-66.95732666666667,1990
1511,1999-10-06,Austin Powers: The Spy Who Shagged Me,35000000,310332636,206040085,1999,275332636,786.6646742857143,1990
1670,1999-10-09,Stigmata,32000000,89441732,50041732,1999,57441732,179.5054125,1990
3163,1999-10-09,A Stir of Echoes,12000000,21133087,21133087,1999,9133087,76.10905833333334,1990
4202,1999-10-09,Love Stinks,4000000,2793776,2793776,1999,-1206224,-30.1556,1990
1725,1999-10-11,Pokemon: The First Movie,30000000,163644662,85744662,1999,133644662,445.4822066666667,1990
3073,1999-10-11,Light It Up,13000000,5871603,5871603,1999,-7128397,-54.833823076923075,1990
778,1999-10-12,The Green Mile,60000000,290701374,136801374,1999,230701374,384.50229,1990
2572,1999-10-12,Deuce Bigalow: Male Gigolo,18000000,92935067,65535067,1999,74935067,416.3059277777778,1990
3233,1999-10-12,Diamonds,11900000,81897,81897,1999,-11818103,-99.31178991596639,1990
740,1999-10-15,Fight Club,65000000,100851897,37030102,1999,35851897,55.15676461538461,1990
1082,1999-10-15,The Story of Us,50000000,27100030,27100030,1999,-22899970,-45.79994,1990
3406,1999-10-15,The Straight Story,10000000,6197866,6197866,1999,-3802134,-38.021339999999995,1990
3706,1999-10-15,The Omega Code,7200000,12678312,12610552,1999,5478312,76.08766666666666,1990
1683,1999-10-22,Bringing Out The Dead,32000000,16640210,16640210,1999,-15359790,-47.99934375,1990
2302,1999-10-22,Molly,21000000,17396,17396,1999,-20982604,-99.91716190476191,1990
2450,1999-10-22,Three to Tango,20000000,10570375,10570375,1999,-9429625,-47.148125,1990
2920,1999-10-22,Crazy in Alabama,15000000,1954202,1954202,1999,-13045798,-86.97198666666667,1990
3518,1999-10-22,The Best Man,9000000,34572780,34102780,1999,25572780,284.142,1990
3810,1999-10-22,Bats,6500000,10155691,10155691,1999,3655691,56.2414,1990
5056,1999-10-22,Beyond the Mat,500000,2047570,2047570,1999,1547570,309.51399999999995,1990
2487,1999-10-29,Mononoke-hime,20000000,150350000,2374107,1999,130350000,651.75,1990
2538,1999-10-29,House on Haunted Hill,19000000,65090541,40846082,1999,46090541,242.58179473684208,1990
3058,1999-10-29,Being John Malkovich,13000000,32382381,22858926,1999,19382381,149.09523846153846,1990
4320,1999-10-29,Dreaming of Joseph Lees,3250000,7680,7680,1999,-3242320,-99.76369230769231,1990
3388,1999-11-06,Le Violon rouge,10000000,10019109,10019109,1999,19109,0.19109,1990
202,1999-11-19,The World is Not Enough,135000000,361730660,126930660,1999,226730660,167.94863703703703,1990
396,1999-11-19,Toy Story 2,90000000,511358276,245852179,1999,421358276,468.17586222222224,1990
646,1999-11-19,Sleepy Hollow,70000000,207068340,101068340,1999,137068340,195.8119142857143,1990
348,1999-11-24,End of Days,100000000,212026975,66889043,1999,112026975,112.02697500000001,1990
1626,1999-11-24,Ride With the Devil,35000000,630779,630779,1999,-34369221,-98.19777428571429,1990
1960,1999-11-24,Flawless,27000000,4485485,4485485,1999,-22514515,-83.3870925925926,1990
5156,1999-11-24,Tumbleweeds,312000,1788168,1350248,1999,1476168,473.1307692307692,1990
844,1999-12-02,My Favorite Martian,60000000,36850101,36850101,1999,-23149899,-38.583165,1990
1575,1999-12-02,Blast from the Past,35000000,26613620,26613620,1999,-8386380,-23.961085714285716,1990
1756,1999-12-02,Message in a Bottle,30000000,52880016,52880016,1999,22880016,76.26671999999999,1990
4124,1999-12-02,Tango,4500000,5428387,1687311,1999,928387,20.63082222222222,1990
1405,1999-12-03,The Deep End of the Ocean,40000000,13508635,13508635,1999,-26491365,-66.2284125,1990
1831,1999-12-03,Wing Commander,30000000,11578022,11578022,1999,-18421978,-61.40659333333333,1990
2296,1999-12-03,The Rage: Carrie 2,21000000,17760244,17760244,1999,-3239756,-15.427409523809525,1990
3051,1999-12-03,Baby Geniuses,13000000,27151490,27151490,1999,14151490,108.85761538461539,1990
3375,1999-12-03,The Corruptor,10000000,15164492,15164492,1999,5164492,51.644920000000006,1990
4360,1999-12-05,Trippin',3000000,9017070,9017070,1999,6017070,200.569,1990
1103,1999-12-11,The Messenger: The Story of Joan of Arc,50000000,14271297,14271297,1999,-35728703,-71.457406,1990
2210,1999-12-11,Anywhere But Here,23000000,18653615,18653615,1999,-4346385,-18.89732608695652,1990
2924,1999-12-11,Felicia's Journey,15000000,1970268,824295,1999,-13029732,-86.86488,1990
3337,1999-12-11,Dogma,10000000,43948865,30651422,1999,33948865,339.48865,1990
313,1999-12-17,Stuart Little,105000000,298815224,140015224,1999,193815224,184.58592761904762,1990
425,1999-12-17,Bicentennial Man,90000000,87420776,58220776,1999,-2579224,-2.865804444444444,1990
604,1999-12-17,Anna and the King,75000000,39251128,39251128,1999,-35748872,-47.66516266666667,1990
1487,1999-12-17,Magnolia,37000000,48446802,22450975,1999,11446802,30.937302702702702,1990
2472,1999-12-17,Topsy Turvy,20000000,6201757,6201757,1999,-13798243,-68.991215,1990
2180,1999-12-21,"Girl, Interrupted",24000000,28871190,28871190,1999,4871190,20.296625,1990
803,1999-12-22,Any Given Sunday,60000000,100230832,75530832,1999,40230832,67.05138666666667,1990
994,1999-12-22,Man on the Moon,52000000,47407635,34580635,1999,-4592365,-8.831471153846154,1990
1175,1999-12-24,Galaxy Quest,45000000,90523726,71423726,1999,45523726,101.16383555555555,1990
1306,1999-12-24,The Talented Mr. Ripley,40000000,128792135,81292135,1999,88792135,221.98033750000002,1990
1500,1999-12-24,Snow Falling on Cedars,36000000,14378353,14378353,1999,-21621647,-60.06013055555556,1990
2114,1999-12-24,Angela's Ashes,25000000,13038660,13038660,1999,-11961340,-47.84536,1990
2189,1999-12-24,Play it to the Bone,24000000,8427204,8427204,1999,-15572796,-64.88665,1990
5354,1999-12-24,Pink Narcissus,27000,8231,8231,1999,-18769,-69.51481481481481,1990
1455,1999-12-29,The Hurricane,38000000,73956241,50699241,1999,35956241,94.62168684210526,1990
528,2000-01-01,Fantasia 2000 (IMAX),80000000,60507228,60507228,2000,-19492772,-24.365965,2000
4186,2000-01-03,3 Strikes,4000000,9821335,9821335,2000,5821335,145.533375,2000
2879,2000-01-09,Highlander: Endgame,15000000,12801190,12801190,2000,-2198810,-14.658733333333332,2000
4375,2000-01-09,Whipped,3000000,4142507,4142507,2000,1142507,38.08356666666667,2000
4880,2000-01-12,Panic,1000000,1425707,779137,2000,425707,42.5707,2000
868,2000-01-14,Supernova,60000000,14816494,14218868,2000,-45183506,-75.30584333333333,2000
5358,2000-01-14,The Terrorist,25000,195043,195043,2000,170043,680.172,2000
3522,2000-01-21,Down to You,9000000,20035310,20035310,2000,11035310,122.61455555555555,2000
3777,2000-01-21,The Boondock Saints,7000000,411874,30471,2000,-6588126,-94.11608571428572,2000
1503,2000-01-28,Isn't She Great,36000000,2954405,2954405,2000,-33045595,-91.79331944444445,2000
2869,2000-01-28,Eye of the Beholder,15000000,18260865,16500786,2000,3260865,21.7391,2000
4219,2000-01-28,The Big Tease,4000000,185577,185577,2000,-3814423,-95.360575,2000
1644,2000-02-06,Big Momma's House,33000000,173559438,117559438,2000,140559438,425.93769090909086,2000
1361,2000-02-18,Hanging Up,40000000,51867723,36037909,2000,11867723,29.6693075,2000
2169,2000-02-18,The Whole Nine Yards,24000000,85527867,57262492,2000,61527867,256.3661125,2000
2204,2000-02-18,Pitch Black,23000000,53182088,39235088,2000,30182088,131.2264695652174,2000
3525,2000-02-18,Boiler Room,9000000,28773637,16963963,2000,19773637,219.70707777777778,2000
1589,2000-02-23,Wonder Boys,35000000,33422485,19389454,2000,-1577515,-4.507185714285714,2000
1499,2000-02-25,Reindeer Games,36000000,23360779,23360779,2000,-12639221,-35.10894722222222,2000
1114,2000-03-03,What Planet Are You From?,50000000,6291602,6291602,2000,-43708398,-87.41679599999999,2000
2106,2000-03-03,The Next Best Thing,25000000,24355762,14983572,2000,-644238,-2.576952,2000
2750,2000-03-03,Drowning Mona,16000000,15980376,15427192,2000,-19624,-0.12265,2000
4574,2000-03-03,Ghost Dog: The Way of the Samurai,2000000,10672492,3330230,2000,8672492,433.6246,2000
403,2000-03-11,Charlie's Angels,90000000,259736090,125305545,2000,169736090,188.59565555555554,2000
854,2000-03-11,The Legend of Bagger Vance,60000000,39235486,30695227,2000,-20764514,-34.60752333333333,2000
1015,2000-03-17,Erin Brockovich,50000000,257805243,125548685,2000,207805243,415.61048600000004,2000
2201,2000-03-17,Final Destination,23000000,112036870,53302314,2000,89036870,387.1168260869565,2000
2035,2000-03-22,Romeo Must Die,25000000,91036760,55973336,2000,66036760,264.14704,2000
2888,2000-03-24,Here on Earth,15000000,10845127,10494147,2000,-4154873,-27.69915333333333,2000
2897,2000-03-24,Whatever it Takes,15000000,8735529,8735529,2000,-6264471,-41.76314,2000
378,2000-03-31,The Road to El Dorado,95000000,65700000,50802661,2000,-29300000,-30.842105263157894,2000
2382,2000-03-31,High Fidelity,20000000,47881663,27277055,2000,27881663,139.408315,2000
2830,2000-03-31,The Skulls,15000000,35007180,35007180,2000,20007180,133.3812,2000
1299,2000-04-02,Scream 3,40000000,161838076,89138076,2000,121838076,304.59519,2000
3432,2000-04-02,Gun Shy,10000000,1638202,1638202,2000,-8361798,-83.61798,2000
417,2000-04-08,Hollow Man,90000000,191200000,73209340,2000,101200000,112.44444444444443,2000
722,2000-04-08,Space Cowboys,65000000,128874043,90454043,2000,63874043,98.26775846153846,2000
1183,2000-04-08,Coyote Ugly,45000000,113916474,60786269,2000,68916474,153.14772000000002,2000
4180,2000-04-08,Saving Grace,4000000,27786849,12178602,2000,23786849,594.671225,2000
4218,2000-04-08,Psycho Beach Party,4000000,267972,267972,2000,-3732028,-93.3007,2000
1241,2000-04-14,28 Days,43000000,62063972,37035515,2000,19063972,44.33481860465116,2000
1869,2000-04-14,Keeping the Faith,29000000,45336404,37036404,2000,16336404,56.332427586206904,2000
3624,2000-04-14,American Psycho,8000000,28674417,15070285,2000,20674417,258.4302125,2000
4374,2000-04-14,East is East,3000000,30438635,4170647,2000,27438635,914.6211666666666,2000
4285,2000-04-19,La otra conquista,3500000,886410,886410,2000,-2613590,-74.67399999999999,2000
763,2000-04-21,U-571,62000000,127630030,77086030,2000,65630030,105.85488709677419,2000
2848,2000-04-21,Love and Basketball,15000000,27709625,27441122,2000,12709625,84.73083333333334,2000
3000,2000-04-21,Gossip,14000000,12591270,5108820,2000,-1408730,-10.062357142857142,2000
3865,2000-04-21,The Virgin Suicides,6000000,10619770,4859475,2000,4619770,76.99616666666667,2000
889,2000-04-28,The Flintstones in Viva Rock Vegas,58000000,59431365,35231365,2000,1431365,2.4678706896551725,2000
1700,2000-04-28,Frequency,31000000,68079671,44983704,2000,37079671,119.61184193548387,2000
2834,2000-04-28,Where the Heart Is,15000000,40862054,33771174,2000,25862054,172.41369333333333,2000
3412,2000-05-04,Black and White,10000000,5241315,5241315,2000,-4758685,-47.586850000000005,2000
319,2000-05-05,Gladiator,103000000,457683805,187683805,2000,354683805,344.35320873786407,2000
1640,2000-05-05,I Dreamed of Africa,34000000,14291999,6543194,2000,-19708001,-57.964708823529406,2000
3728,2000-05-05,Michael Jordan to the MAX,7000000,18642318,18642318,2000,11642318,166.31882857142855,2000
4314,2000-05-05,Human Traffic,3300000,5422740,104257,2000,2122740,64.32545454545455,2000
4773,2000-05-05,The Basket,1300000,609042,609042,2000,-690958,-53.150615384615385,2000
4892,2000-05-05,Luminarias,1000000,428535,428535,2000,-571465,-57.1465,2000
228,2000-05-19,Dinosaur,127500000,356148063,137748063,2000,228648063,179.33181411764704,2000
2606,2000-05-19,Small Time Crooks,18000000,29934477,17266359,2000,11934477,66.30265,2000
2727,2000-05-19,Road Trip,16000000,119739110,68525609,2000,103739110,648.3694375,2000
254,2000-05-24,Mission: Impossible 2,120000000,549588516,215409889,2000,429588516,357.99043,2000
935,2000-05-26,Shanghai Noon,55000000,71189835,56932305,2000,16189835,29.436063636363635,2000
4599,2000-05-26,Hum to Mohabbt Karega,2000000,121807,121807,2000,-1878193,-93.90965,2000
909,2000-06-10,Meet the Parents,55000000,304599899,166225040,2000,249599899,453.8179981818182,2000
1397,2000-06-10,Get Carter,40000000,19417182,14967182,2000,-20582818,-51.457045,2000
3426,2000-06-10,Bamboozled,10000000,2373937,2185266,2000,-7626063,-76.26062999999999,2000
4022,2000-06-10,Digimon: The Movie,5000000,16628751,9628751,2000,11628751,232.57502,2000
4121,2000-06-10,Requiem for a Dream,4500000,7389233,3635482,2000,2889233,64.20517777777778,2000
554,2000-06-16,Fantasia 2000 (Theatrical Release),80000000,9103630,9103630,2000,-70896370,-88.6204625,2000
610,2000-06-16,Titan A.E.,75000000,36751979,22751979,2000,-38248021,-50.99736133333334,2000
976,2000-06-16,Shaft,53012938,107190108,70327868,2000,54177170,102.19612804708164,2000
2745,2000-06-16,Boys and Girls,16000000,21799652,21799652,2000,5799652,36.247825,2000
4485,2000-06-16,Jesus' Son,2500000,1687548,1282084,2000,-812452,-32.49808,2000
1249,2000-06-21,Chicken Run,42000000,227793915,106793915,2000,185793915,442.3664642857143,2000
997,2000-06-23,"Me, Myself & Irene",51000000,149270999,90570999,2000,98270999,192.68823333333333,2000
5273,2000-06-23,Woman Chaser,150000,110719,110719,2000,-39281,-26.187333333333335,2000
291,2000-06-28,The Patriot,110000000,215300000,113330342,2000,105300000,95.72727272727273,2000
255,2000-06-30,The Perfect Storm,120000000,328711434,182618434,2000,208711434,173.926195,2000
571,2000-06-30,The Adventures of Rocky & Bullwinkle,76000000,35129610,26000610,2000,-40870390,-53.776828947368415,2000
812,2000-07-04,Rules of Engagement,60000000,71719931,61322858,2000,11719931,19.533218333333334,2000
2176,2000-07-04,Return to Me,24000000,32662299,32662299,2000,8662299,36.092912500000004,2000
2187,2000-07-04,Ready to Rumble,24000000,12372410,12372410,2000,-11627590,-48.44829166666666,2000
728,2000-07-07,The Kid,65000000,69688384,69688384,2000,4688384,7.212898461538461,2000
2529,2000-07-07,Scary Movie,19000000,277200000,157019771,2000,258200000,1358.9473684210527,2000
4803,2000-07-07,But I'm a Cheerleader,1200000,2509344,2205627,2000,1309344,109.11200000000001,2000
581,2000-07-14,X-Men,75000000,296339717,157299717,2000,221339717,295.11962266666666,2000
5191,2000-07-14,Chuck&Buck,250000,1157672,1055671,2000,907672,363.0688,2000
2908,2000-07-19,The In Crowd,15000000,5217498,5217498,2000,-9782502,-65.21668000000001,2000
400,2000-07-21,What Lies Beneath,90000000,288693989,155464351,2000,198693989,220.7710988888889,2000
1767,2000-07-21,Pokemon 2000,30000000,133946923,43746923,2000,103946923,346.4897433333333,2000
2426,2000-07-21,Loser,20000000,18250106,15464026,2000,-1749894,-8.749469999999999,2000
2545,2000-07-26,Thomas and the Magic Railroad,19000000,15911332,15911332,2000,-3088668,-16.256147368421054,2000
476,2000-07-28,Nutty Professor II: The Klumps,84000000,166307945,123307945,2000,82307945,97.98564880952381,2000
1650,2000-08-09,The Watcher,33000000,47267829,28946615,2000,14267829,43.235845454545455,2000
2181,2000-08-09,Nurse Betty,24000000,27732366,25170054,2000,3732366,15.551525,2000
3535,2000-08-09,The Way of the Gun,9000000,13061935,6047856,2000,4061935,45.13261111111111,2000
4499,2000-08-09,Anatomie,2500000,9598,9598,2000,-2490402,-99.61608,2000
4882,2000-08-09,Fiza,1000000,1179462,623791,2000,179462,17.9462,2000
593,2000-08-12,Vertical Limit,75000000,213500000,68473360,2000,138500000,184.66666666666666,2000
743,2000-08-12,Proof of Life,65000000,62761005,32598931,2000,-2238995,-3.4446076923076925,2000
1597,2000-08-12,Dungeons and Dragons,35000000,33771965,15185241,2000,-1228035,-3.508671428571428,2000
2794,2000-08-12,"Crouching Tiger, Hidden Dragon",15000000,213514672,128067808,2000,198514672,1323.4311466666666,2000
3339,2000-08-12,Snatch,10000000,83593107,30093107,2000,73593107,735.93107,2000
1533,2000-08-18,The Cell,35000000,85911226,61280963,2000,50911226,145.46064571428573,2000
4336,2000-08-18,The Original Kings of Comedy,3000000,38236338,38168022,2000,35236338,1174.5446,2000
4852,2000-08-18,Godzilla 2000,1000000,10037390,10037390,2000,9037390,903.739,2000
1372,2000-08-25,The Art of War,40000000,30199105,30199105,2000,-9800895,-24.5022375,2000
2214,2000-08-25,The Crew,23000000,13019253,13019253,2000,-9980747,-43.39455217391304,2000
3309,2000-08-25,Bring it On,10000000,90453550,68353550,2000,80453550,804.5355000000001,2000
5342,2000-08-25,Smiling Fish and Goat on Fire,40000,277233,277233,2000,237233,593.0825,2000
318,2000-09-06,Gone in 60 Seconds,103300000,232643008,101643008,2000,129343008,125.2110435624395,2000
5060,2000-09-06,Groove,500000,1167524,1115313,2000,667524,133.5048,2000
850,2000-09-15,Almost Famous,60000000,47371191,32522352,2000,-12628809,-21.048015,2000
1596,2000-09-15,Bait,35000000,15471969,15325127,2000,-19528031,-55.79437428571429,2000
2763,2000-09-15,Duets,16000000,6615452,4734235,2000,-9384548,-58.653425000000006,2000
5226,2000-09-15,Urbania,225000,1032075,1032075,2000,807075,358.70000000000005,2000
2857,2000-09-22,Urban Legends: Final Cut,15000000,38574362,21468807,2000,23574362,157.16241333333335,2000
3110,2000-09-22,Dancer in the Dark,12500000,45557491,4157491,2000,33057491,264.459928,2000
3635,2000-09-22,Woman on Top,8000000,10192613,5018450,2000,2192613,27.4076625,2000
4913,2000-09-22,The Specials,1000000,12996,12996,2000,-987004,-98.7004,2000
3846,2000-09-27,Best in Show,6000000,20695413,18621249,2000,14695413,244.92354999999998,2000
1713,2000-09-29,Remember the Titans,30000000,136706683,115654751,2000,106706683,355.6889433333333,2000
3540,2000-09-29,Beautiful,9000000,3134509,3134509,2000,-5865491,-65.17212222222221,2000
4872,2000-09-29,The Broken Hearts Club: A Romantic Comedy,1000000,2022442,1744858,2000,1022442,102.2442,2000
424,2000-10-03,Mission to Mars,90000000,106000000,60874615,2000,16000000,17.77777777777778,2000
1464,2000-10-03,The Ninth Gate,38000000,58394308,18653746,2000,20394308,53.669231578947375,2000
4986,2000-10-03,Deterrence,800000,371647,144583,2000,-428353,-53.544125,2000
5158,2000-10-03,God's Army,300000,2652515,2637726,2000,2352515,784.1716666666666,2000
533,2000-10-11,Little Nicky,80000000,58270391,39442871,2000,-21729609,-27.162011250000003,2000
551,2000-10-11,Red Planet,80000000,33463969,17480890,2000,-46536031,-58.170038749999996,2000
1671,2000-10-11,Men of Honor,32000000,82339483,48814909,2000,50339483,157.310884375,2000
4796,2000-10-11,You Can Count on Me,1200000,10827356,9180275,2000,9627356,802.2796666666667,2000
1917,2000-10-13,Lost Souls,28000000,31320293,16779636,2000,3320293,11.858189285714285,2000
3264,2000-10-13,The Ladies Man,11000000,13719474,13592872,2000,2719474,24.722490909090908,2000
3524,2000-10-13,The Contender,9000000,17804273,17804273,2000,8804273,97.82525555555556,2000
3983,2000-10-13,Billy Elliot,5000000,109273197,21995263,2000,104273197,2085.46394,2000
4410,2000-10-13,Just Looking,3000000,39852,39852,2000,-2960148,-98.6716,2000
1137,2000-10-20,Bedazzled,48000000,90376224,37879996,2000,42376224,88.2838,2000
1364,2000-10-20,Pay it Forward,40000000,55696705,33508922,2000,15696705,39.2417625,2000
2497,2000-10-20,The Yards,20000000,2282710,882710,2000,-17717290,-88.58645,2000
4552,2000-10-20,The Legend of Drunken Master,2000000,11546543,11546543,2000,9546543,477.32714999999996,2000
752,2000-10-27,Lucky Numbers,65000000,10014234,10014234,2000,-54985766,-84.59348615384616,2000
2264,2000-10-27,The Little Vampire,22000000,13555988,13555988,2000,-8444012,-38.38187272727273,2000
2849,2000-10-27,Book of Shadows: Blair Witch 2,15000000,47721314,26421314,2000,32721314,218.14209333333335,2000
3948,2000-10-27,A Room for Romeo Brass,5250000,20097,20097,2000,-5229903,-99.6172,2000
5340,2000-10-27,George Washington,42000,342722,241816,2000,300722,716.004761904762,2000
5030,2000-10-31,Mercy Streets,600000,173599,173599,2000,-426401,-71.06683333333334,2000
1065,2000-11-02,The Beach,50000000,39778599,39778599,2000,-10221401,-20.442802,2000
2346,2000-11-02,The Tigger Movie,20000000,96147688,45542421,2000,76147688,380.73844,2000
3036,2000-11-02,Snow Day,13000000,62452927,60008303,2000,49452927,380.4071307692308,2000
5235,2000-11-02,Trois,200000,1161843,1161843,2000,961843,480.9215,2000
1057,2000-11-08,The Replacements,50000000,50054511,44737059,2000,54511,0.10902200000000001,2000
1356,2000-11-08,Autumn in New York,40000000,90717684,37752931,2000,50717684,126.79420999999999,2000
1374,2000-11-08,Bless the Child,40000000,40435694,29374178,2000,435694,1.089235,2000
3437,2000-11-08,Cecil B. Demented,10000000,1953882,1276984,2000,-8046118,-80.46118,2000
3793,2000-11-08,Aimée & Jaguar,6800000,927107,927107,2000,-5872893,-86.36607352941176,2000
253,2000-11-17,How the Grinch Stole Christmas,123000000,345141403,260044825,2000,222141403,180.60276666666667,2000
484,2000-11-17,The 6th Day,82000000,96024898,34543701,2000,14024898,17.103534146341463,2000
1557,2000-11-17,Bounce,35000000,53425292,36805288,2000,18425292,52.64369142857143,2000
1731,2000-11-17,Rugrats in Paris,30000000,103284813,76501438,2000,73284813,244.28271,2000
456,2000-11-22,102 Dalmatians,85000000,66941559,66941559,2000,-18058441,-21.245224705882354,2000
617,2000-11-22,Unbreakable,73243106,248099143,94999143,2000,174856037,238.7337819889834,2000
3023,2000-11-22,Quills,13500000,11732088,7060876,2000,-1767912,-13.095644444444442,2000
3495,2000-12-01,Next Friday,9500000,59675307,57176582,2000,50175307,528.1611263157895,2000
3715,2000-12-01,My Dog Skip,7000000,35795319,34099640,2000,28795319,411.3617,2000
544,2000-12-05,Battlefield Earth: A Saga of the Year 3000,80000000,29725663,21471685,2000,-50274337,-62.842921249999996,2000
2607,2000-12-05,Center Stage,18000000,21361109,17200925,2000,3361109,18.67282777777778,2000
3186,2000-12-05,Screwed,12000000,6982680,6982680,2000,-5017320,-41.811,2000
3636,2000-12-05,Held Up,8000000,4714090,4714090,2000,-3285910,-41.073875,2000
4582,2000-12-05,Hamlet,2000000,2419669,1577287,2000,419669,20.98345,2000
342,2000-12-15,The Emperor's New Groove,100000000,169296573,89296573,2000,69296573,69.296573,2000
707,2000-12-15,What Women Want,65000000,374105123,182805123,2000,309105123,475.54634307692305,2000
2029,2000-12-15,Chocolat,25000000,152500343,71309760,2000,127500343,510.00137199999995,2000
3044,2000-12-15,"Dude, Where's My Car?",13000000,73180297,46729374,2000,60180297,462.9253615384616,2000
3859,2000-12-15,Pollock,6000000,10557291,8596914,2000,4557291,75.95485,2000
1240,2000-12-19,Finding Forrester,43000000,80013623,51768623,2000,37013623,86.0781930232558,2000
3382,2000-12-19,The Gift,10000000,44567606,12008642,2000,34567606,345.67606,2000
439,2000-12-22,Cast Away,85000000,427230516,233632142,2000,342230516,402.6241364705882,2000
540,2000-12-22,Thirteen Days,80000000,66554547,34566746,2000,-13445453,-16.80681625,2000
801,2000-12-22,The Family Man,60000000,124715863,75764085,2000,64715863,107.85977166666667,2000
1164,2000-12-22,Miss Congeniality,45000000,213420951,106807667,2000,168420951,374.26878,2000
1217,2000-12-22,All the Pretty Horses,45000000,18120267,15527125,2000,-26879733,-59.73273999999999,2000
1907,2000-12-22,Dracula 2000,28000000,33000377,33000377,2000,5000377,17.858489285714285,2000
1981,2000-12-22,"O Brother, Where Art Thou?",26000000,75763814,45506619,2000,49763814,191.39928461538463,2000
3422,2000-12-22,The House of Mirth,10000000,5149131,3041803,2000,-4850869,-48.50869,2000
4225,2000-12-22,An Everlasting Piece,4000000,75078,75078,2000,-3924922,-98.12305,2000
1126,2000-12-27,Traffic,48000000,208300000,124107476,2000,160300000,333.9583333333333,2000
3089,2000-12-29,The Claim,13000000,1375635,622023,2000,-11624365,-89.41819230769231,2000
3631,2000-12-29,Shadow of the Vampire,8000000,8279017,8279017,2000,279017,3.4877125,2000
1791,2001-01-06,What's the Worst That Could Happen?,30000000,38462071,32267774,2001,8462071,28.206903333333333,2000
2238,2001-01-06,The Animal,22000000,55762229,55762229,2001,33762229,153.46467727272727,2000
1212,2001-01-19,The Pledge,45000000,29406132,19719930,2001,-15593868,-34.653040000000004,2000
1894,2001-01-26,The Wedding Planner,28000000,94728529,60400856,2001,66728529,238.31617500000002,2000
2563,2001-02-02,Left Behind,18500000,4221341,4221341,2001,-14278659,-77.18194054054054,2000
2995,2001-02-02,Head Over Heels,14000000,10397365,10397365,2001,-3602635,-25.733107142857143,2000
3358,2001-02-02,Valentine,10000000,20384136,20384136,2001,10384136,103.84136,2000
1318,2001-02-03,The Mexican,40000000,145238250,66808615,2001,105238250,263.095625,2000
2738,2001-02-03,See Spot Run,16000000,43057552,33357476,2001,27057552,169.1097,2000
3026,2001-02-03,The Caveman's Valentine,13500000,892506,687081,2001,-12607494,-93.38884444444444,2000
3079,2001-02-03,The Widow of St. Pierre,13000000,3058380,3058380,2001,-9941620,-76.474,2000
275,2001-02-11,"Monsters, Inc.",115000000,559757719,289423425,2001,444757719,386.7458426086956,2000
982,2001-02-11,Domestic Disturbance,53000000,54207112,45207112,2001,1207112,2.2775698113207548,2000
1120,2001-02-11,The One,49000000,72689126,43905746,2001,23689126,48.34515510204081,2000
3299,2001-02-11,Le Fabuleux destin d'Amélie Poulain,10350000,174201661,33201661,2001,163851661,1583.1078357487922,2000
5087,2001-02-11,Everything Put Together,500000,7890,0,2001,-492110,-98.422,2000
1381,2001-02-16,Sweet November,40000000,65754228,25288103,2001,25754228,64.38557,2000
1739,2001-02-16,Down to Earth,30000000,71172251,64172251,2001,41172251,137.24083666666667,2000
3324,2001-02-16,Recess: School's Out,10000000,44451470,36696761,2001,34451470,344.5147,2000
614,2001-02-23,Monkeybone,75000000,5409517,5409517,2001,-69590483,-92.78731066666667,2000
767,2001-02-23,3000 Miles to Graceland,62000000,18708848,15738632,2001,-43291152,-69.82443870967742,2000
397,2001-03-08,Rush Hour 2,90000000,347425832,226164286,2001,257425832,286.02870222222225,2000
1718,2001-03-08,The Princess Diaries,30000000,165334774,108244774,2001,135334774,451.1159133333333,2000
1990,2001-03-08,Original Sin,26000000,16521410,16521410,2001,-9478590,-36.45611538461539,2000
461,2001-03-16,Enemy at the Gates,85000000,96971293,51396781,2001,11971293,14.083874117647058,2000
1645,2001-03-16,Exit Wounds,33000000,79958599,51758599,2001,46958599,142.29878484848484,2000
3979,2001-03-16,Memento,5000000,39723096,25544867,2001,34723096,694.46192,2000
5192,2001-03-16,American Desi,250000,1366235,902835,2001,1116235,446.494,2000
5330,2001-03-16,Gabriela,50000,2335352,2335352,2001,2285352,4570.704,2000
1457,2001-03-23,Heartbreakers,38000000,57753825,40334024,2001,19753825,51.98374999999999,2000
2135,2001-03-23,Say It Isn't So,25000000,5516708,5516708,2001,-19483292,-77.933168,2000
3837,2001-03-23,The Brothers,6000000,27958191,27457409,2001,21958191,365.96985,2000
1518,2001-03-30,Spy Kids,35000000,197692062,112692062,2001,162692062,464.83446285714285,2000
2205,2001-03-30,Someone Like You,23000000,38684906,27338033,2001,15684906,68.19524347826086,2000
2616,2001-03-30,Tailor of Panama,18000000,27491653,13491653,2001,9491653,52.731405555555554,2000
3265,2001-03-30,Tomcats,11000000,13558739,13558739,2001,2558739,23.261263636363637,2000
4566,2001-03-30,Amores Perros,2000000,20883834,5383834,2001,18883834,944.1917,2000
368,2001-04-05,The Mummy Returns,98000000,435040395,202007640,2001,337040395,343.91877040816325,2000
4605,2001-04-05,Eureka,2000000,76654,49388,2001,-1923346,-96.1673,2000
790,2001-04-07,Cats & Dogs,60000000,200700000,93375151,2001,140700000,234.50000000000003,2000
1176,2001-04-07,Scary Movie 2,45000000,141189101,71277420,2001,96189101,213.7535577777778,2000
2028,2001-04-13,Bridget Jones's Diary,25000000,281527158,71500556,2001,256527158,1026.108632,2000
2082,2001-04-20,Crocodile Dundee in Los Angeles,25000000,39393111,25590119,2001,14393111,57.572444,2000
2873,2001-04-20,Freddy Got Fingered,15000000,14249005,14249005,2001,-750995,-5.006633333333333,2000
317,2001-04-27,Town & Country,105000000,10364769,6712451,2001,-94635231,-90.12879142857143,2000
629,2001-04-27,Driven,72000000,54616869,32616869,2001,-17383131,-24.1432375,2000
3664,2001-04-27,Akira,8000000,19585,19585,2001,-7980415,-99.75518749999999,2000
4027,2001-04-27,The Forsaken,5000000,6755271,6755271,2001,1755271,35.105419999999995,2000
1173,2001-05-10,Training Day,45000000,104505362,76261036,2001,59505362,132.23413777777776,2000
1899,2001-05-10,Serendipity,28000000,77477297,50255310,2001,49477297,176.70463214285715,2000
2207,2001-05-10,Joy Ride,23000000,21973182,21973182,2001,-1026818,-4.4644260869565215,2000
3170,2001-05-10,Max Keeble's Big Move,12000000,17292381,17292381,2001,5292381,44.103175,2000
981,2001-05-18,Moulin Rouge,53000000,179209685,57386369,2001,126209685,238.13148113207546,2000
1002,2001-05-18,Shrek,50000000,491812794,267655011,2001,441812794,883.625588,2000
1462,2001-05-18,Angel Eyes,38000000,29544532,24044532,2001,-8455468,-22.25123157894737,2000
132,2001-05-25,Pearl Harbor,151500000,449239855,198539855,2001,297739855,196.52795709570955,2000
1419,2001-06-04,Just Visiting,40000000,16172200,4777007,2001,-23827800,-59.5695,2000
1755,2001-06-04,Blow,30000000,83282296,52990775,2001,53282296,177.60765333333333,2000
1886,2001-06-04,Along Came a Spider,28000000,105159085,74058698,2001,77159085,275.5681607142857,2000
4350,2001-06-04,Pokemon 3: The Movie,3000000,68452128,17052128,2001,65452128,2181.7376,2000
4879,2001-06-04,Brigham City,1000000,852206,852206,2001,-147794,-14.7794,2000
2060,2001-06-07,Kiss of the Dragon,25000000,36833473,36833473,2001,11833473,47.333892,2000
5377,2001-06-07,Cure,10000,94596,94596,2001,84596,845.96,2000
4151,2001-06-13,Sexy Beast,4300000,10158355,6946056,2001,5858355,136.24081395348838,2000
385,2001-06-15,Lara Croft: Tomb Raider,94000000,273330185,131144183,2001,179330185,190.77679255319148,2000
4669,2001-06-15,Songcatcher,1800000,3050934,3050934,2001,1250934,69.49633333333334,2000
626,2001-06-22,Doctor Dolittle 2,72000000,176101721,112950721,2001,104101721,144.5857236111111,2000
1444,2001-06-22,The Fast and the Furious,38000000,206512310,144512310,2001,168512310,443.45344736842105,2000
2740,2001-06-27,Baby Boy,16000000,28734552,28734552,2001,12734552,79.59095,2000
415,2001-06-29,Artificial Intelligence: AI,90000000,235900000,78616689,2001,145900000,162.11111111111111,2000
3063,2001-06-29,crazy/beautiful,13000000,19929123,16929123,2001,6929123,53.300946153846155,2000
4284,2001-06-29,Pootie Tang,3500000,3293258,3293258,2001,-206742,-5.906914285714286,2000
1378,2001-07-09,The Musketeer,40000000,27053815,27053815,2001,-12946185,-32.3654625,2000
1466,2001-07-09,Rock Star,38000000,19317765,16991902,2001,-18682235,-49.16377631578948,2000
3005,2001-07-09,Soul Survivors,14000000,4288246,3100650,2001,-9711754,-69.36967142857144,2000
3059,2001-07-09,Two Can Play That Game,13000000,22391450,22235901,2001,9391450,72.24192307692307,2000
5013,2001-07-09,L.I.E.,700000,1140965,1140965,2001,440965,62.995000000000005,2000
441,2001-07-12,Ocean's Eleven,85000000,450728529,183417150,2001,365728529,430.26885764705884,2000
3881,2001-07-12,The Business of Strangers,6000000,1290920,1030920,2001,-4709080,-78.48466666666667,2000
4877,2001-07-12,No Man's Land,1000000,2684207,1067481,2001,1684207,168.4207,2000
692,2001-07-13,The Score,68000000,113542091,71069884,2001,45542091,66.97366323529413,2000
2568,2001-07-13,Legally Blonde,18000000,141809235,96493426,2001,123809235,687.8290833333334,2000
4033,2001-07-13,Made,5000000,5476060,5308707,2001,476060,9.5212,2000
4534,2001-07-13,Bully,2100000,1381824,881824,2001,-718176,-34.19885714285714,2000
387,2001-07-18,Jurassic Park III,93000000,365900000,181166115,2001,272900000,293.44086021505376,2000
1153,2001-07-20,America's Sweethearts,46000000,160648493,93607673,2001,114648493,249.2358543478261,2000
3211,2001-07-20,Brother,12000000,450594,450594,2001,-11549406,-96.24504999999999,2000
3875,2001-07-20,Hedwig and the Angry Inch,6000000,3747270,3067312,2001,-2252730,-37.5455,2000
3927,2001-07-20,Ghost World,5500000,8761608,6217849,2001,3261608,59.30196363636364,2000
329,2001-07-27,Planet of the Apes,100000000,362211740,180011740,2001,262211740,262.21174,2000
5133,2001-07-27,Jackpot,400000,44452,44452,2001,-355548,-88.887,2000
412,2001-08-06,Atlantis: The Lost Empire,90000000,186049020,84052762,2001,96049020,106.72113333333333,2000
523,2001-08-06,Swordfish,80000000,147080413,69772969,2001,67080413,83.85051625,2000
535,2001-08-06,Evolution,80000000,98341932,38311134,2001,18341932,22.927415,2000
4362,2001-08-08,The Deep End,3000000,9981635,8823109,2001,6981635,232.72116666666665,2000
2904,2001-08-10,Mulholland Drive,15000000,11919578,7219578,2001,-3080422,-20.536146666666667,2000
1135,2001-08-13,K-PAX,48000000,50315140,50315140,2001,2315140,4.8232083333333335,2000
901,2001-08-17,Captain Corelli's Mandolin,57000000,62097495,25528495,2001,5097495,8.942973684210525,2000
1133,2001-08-17,Rat Race,48000000,86607223,56607223,2001,38607223,80.43171458333333,2000
1601,2001-08-17,American Outlaws,35000000,13601109,13264986,2001,-21398891,-61.13968857142857,2000
3818,2001-08-17,Aberdeen,6500000,64148,64148,2001,-6435852,-99.01310769230768,2000
4902,2001-08-22,Lisa Picard is Famous,1000000,113433,113433,2001,-886567,-88.6567,2000
1922,2001-08-24,John Carpenter's Ghosts of Mars,28000000,8434601,8434601,2001,-19565399,-69.876425,2000
1995,2001-08-24,The Curse of the Jade Scorpion,26000000,18496522,7496522,2001,-7503478,-28.85953076923077,2000
2249,2001-08-24,Jay and Silent Bob Strike Back,22000000,33762400,30059386,2001,11762400,53.46545454545455,2000
2692,2001-08-24,Summer Catch,17000000,19693891,19693891,2001,2693891,15.846417647058825,2000
3074,2001-08-24,Bubble Boy,13000000,5002310,5002310,2001,-7997690,-61.5206923076923,2000
3322,2001-08-31,Jeepers Creepers,10000000,58939035,37904175,2001,48939035,489.39035,2000
3997,2001-08-31,O (Othello),5000000,16017403,16017403,2001,11017403,220.34805999999998,2000
4911,2001-08-31,Speedway Junky,1000000,17127,17127,2001,-982873,-98.2873,2000
437,2001-09-02,Hannibal,87000000,350100280,165092266,2001,263100280,302.4141149425287,2000
2257,2001-09-02,Saving Silverman,22000000,25873142,19351569,2001,3873142,17.605190909090908,2000
1262,2001-09-03,15 Minutes,42000000,56331864,24375436,2001,14331864,34.123485714285714,2000
3219,2001-09-03,Company Man,12000000,622273,146028,2001,-11377727,-94.81439166666667,2000
3384,2001-09-03,Get Over It,10000000,19860259,11560259,2001,9860259,98.60259,2000
5375,2001-09-03,Dayereh,10000,673780,673780,2001,663780,6637.8,2000
1314,2001-09-11,Shallow Hal,40000000,70836296,70836296,2001,30836296,77.09074,2000
1580,2001-09-11,Heist,35000000,28906817,23483357,2001,-6093183,-17.409094285714286,2000
5305,2001-09-11,Keeping it Real: The Adventures of Greg Walloch,100000,1358,1358,2001,-98642,-98.642,2000
2259,2001-09-14,The Glass House,22000000,22861785,17951431,2001,861785,3.9172045454545454,2000
2289,2001-09-14,Hardball,21000000,43728560,40222729,2001,22728560,108.2312380952381,2000
2269,2001-09-21,Megiddo: Omega Code 2,22000000,6047691,6047691,2001,-15952309,-72.51049545454545,2000
3582,2001-09-21,Glitter,8500000,4273372,4273372,2001,-4226628,-49.725035294117646,2000
1044,2001-09-28,Don’t Say a Word,50000000,104488383,54997476,2001,54488383,108.976766,2000
1701,2001-09-28,Hearts in Atlantis,31000000,30885781,24185781,2001,-114219,-0.3684483870967742,2000
1901,2001-09-28,Zoolander,28000000,60780981,45172250,2001,32780981,117.07493214285714,2000
4589,2001-09-28,Dinner Rush,2000000,1075504,638227,2001,-924496,-46.2248,2000
682,2001-10-08,Osmosis Jones,70000000,13596911,13596911,2001,-56403089,-80.57584142857142,2000
1708,2001-10-08,American Pie 2,30000000,286500000,145096820,2001,256500000,855.0000000000001,2000
2666,2001-10-08,The Others,17000000,207765056,96522687,2001,190765056,1122.147388235294,2000
4732,2001-10-08,Session 9,1500000,1619602,378176,2001,119602,7.973466666666666,2000
866,2001-10-19,The Last Castle,60000000,20541668,18208078,2001,-39458332,-65.76388666666666,2000
1146,2001-10-19,Riding in Cars with Boys,47000000,29781453,29781453,2001,-17218547,-36.63520638297872,2000
1566,2001-10-19,From Hell,35000000,68712365,31598308,2001,33712365,96.32104285714286,2000
3398,2001-10-24,Bones,10000000,8378853,7316658,2001,-1621147,-16.21147,2000
2537,2001-10-26,Thirteen Ghosts,19000000,68467960,41867960,2001,49467960,260.3576842105263,2000
2611,2001-10-26,Life as a House,18000000,23889158,15652637,2001,5889158,32.71754444444445,2000
3414,2001-10-26,On the Line,10000000,4690802,4365455,2001,-5309198,-53.09198000000001,2000
3453,2001-10-26,High Heels and Low Lifes,10000000,226792,226792,2001,-9773208,-97.73208,2000
4126,2001-10-26,Donnie Darko,4500000,7503672,1472801,2001,3003672,66.74826666666667,2000
2262,2001-11-04,Josie and the Pussycats,22000000,14252830,14252830,2001,-7747170,-35.21440909090909,2000
2741,2001-11-04,Joe Dirt,16000000,30987695,27087695,2001,14987695,93.67309375,2000
3725,2001-11-04,Kingdom Come,7000000,23393939,23247539,2001,16393939,234.19912857142856,2000
1273,2001-11-05,A Knight’s Tale,41000000,100622586,56083966,2001,59622586,145.42094146341464,2000
198,2001-11-07,Final Fantasy: The Spirits Within,137000000,85131830,32131830,2001,-51868170,-37.85997810218978,2000
4185,2001-11-14,The Wash,4000000,10097096,10097096,2001,6097096,152.42739999999998,2000
233,2001-11-16,Harry Potter and the Sorcerer’s Stone,125000000,974755371,317575550,2001,849755371,679.8042968,2000
3878,2001-11-16,Novocaine,6000000,2522928,2025238,2001,-3477072,-57.9512,2000
422,2001-11-21,Spy Game,90000000,143049560,62362560,2001,53049560,58.94395555555556,2000
1562,2001-11-21,Black Knight,35000000,33422806,33422806,2001,-1577194,-4.5062685714285715,2000
3263,2001-11-21,Out Cold,11000000,14786394,13906394,2001,3786394,34.421763636363636,2000
4870,2001-11-21,The Sidewalks of New York,1000000,3575308,2402459,2001,2575308,257.5308,2000
4684,2001-11-23,In the Bedroom,1700000,42137871,35930604,2001,40437871,2378.698294117647,2000
1324,2001-11-30,Behind Enemy Lines,40000000,58855732,58855732,2001,18855732,47.13933,2000
1471,2001-11-30,Texas Rangers,38000000,623374,623374,2001,-37376626,-98.35954210526316,2000
1832,2001-12-01,Antitrust,30000000,17865209,10965209,2001,-12134791,-40.44930333333333,2000
2179,2001-12-01,Double Take,24000000,29823162,29823162,2001,5823162,24.263175,2000
3033,2001-12-01,Save the Last Dance,13000000,122244329,91038276,2001,109244329,840.3409923076923,2000
603,2001-12-10,Bandits,75000000,71523271,41523271,2001,-3476729,-4.635638666666667,2000
3258,2001-12-10,Corky Romano,11000000,25116103,23978402,2001,14116103,128.3282090909091,2000
647,2001-12-14,Vanilla Sky,70000000,202726605,100614858,2001,132726605,189.60943571428572,2000
1897,2001-12-14,The Royal Tenenbaums,28000000,71430876,52353636,2001,43430876,155.11027142857142,2000
2825,2001-12-14,Not Another Teen Movie,15000000,62401343,37882551,2001,47401343,316.0089533333333,2000
3751,2001-12-14,The Other Side of Heaven,7000000,4720371,4720371,2001,-2279629,-32.56612857142857,2000
3928,2001-12-14,Iris,5500000,15155021,5580479,2001,9655021,175.54583636363637,2000
308,2001-12-19,The Lord of the Rings: The Fellowship of the Ring,109000000,887210985,315544750,2001,778210985,713.9550321100917,2000
560,2001-12-21,A Beautiful Mind,78000000,317668058,170708996,2001,239668058,307.266741025641,2000
630,2001-12-21,The Majestic,72000000,37306334,27796042,2001,-34693666,-48.18564722222222,2000
1463,2001-12-21,Joe Somebody,38000000,24515990,22770864,2001,-13484010,-35.48423684210527,2000
2021,2001-12-21,Jimmy Neutron: Boy Genius,25000000,102992536,80936232,2001,77992536,311.970144,2000
3150,2001-12-21,How High,12000000,31222395,31155435,2001,19222395,160.186625,2000
310,2001-12-25,Ali,109000000,87683966,58183966,2001,-21316034,-19.555994495412843,2000
1136,2001-12-25,Kate and Leopold,48000000,70937778,47095453,2001,22937778,47.787037500000004,2000
1603,2001-12-25,The Shipping News,35000000,24405825,11405825,2001,-10594175,-30.269071428571433,2000
2587,2001-12-26,Gosford Park,18000000,41300105,41300105,2001,23300105,129.44502777777777,2000
4169,2001-12-26,Monster's Ball,4000000,43766463,31273922,2001,39766463,994.1615750000001,2000
372,2001-12-28,Black Hawk Down,95000000,159691085,108638745,2001,64691085,68.09587894736842,2000
2244,2001-12-28,I Am Sam,22000000,92542418,40270895,2001,70542418,320.64735454545456,2000
3695,2001-12-31,The Hole,7500000,10834406,0,2001,3334406,44.45874666666666,2000
3075,2002-01-02,Birthday Girl,13000000,8130727,4919896,2002,-4869273,-37.455946153846156,2000
3271,2002-01-02,Slackers,11000000,4814244,4814244,2002,-6185756,-56.234145454545455,2000
5057,2002-01-02,The Singles Ward,500000,1250798,1250798,2002,750798,150.15959999999998,2000
653,2002-01-03,We Were Soldiers,70000000,114658262,78120196,2002,44658262,63.79751714285714,2000
2682,2002-01-03,40 Days and 40 Nights,17000000,95092667,37939782,2002,78092667,459.3686294117647,2000
5269,2002-01-03,The Calling,160000,32092,32092,2002,-127908,-79.94250000000001,2000
671,2002-01-11,I Spy,70000000,60279822,33561137,2002,-9720178,-13.885968571428572,2000
713,2002-01-11,The Santa Clause 2,65000000,172825854,139225854,2002,107825854,165.88592923076925,2000
1665,2002-01-18,Snow Dogs,32000000,116898028,81150692,2002,84898028,265.3063375,2000
1259,2002-01-25,The Mothman Prophecies,42000000,56438555,35228696,2002,14438555,34.3775119047619,2000
1332,2002-01-25,The Count of Monte Cristo,40000000,75389090,54228104,2002,35389090,88.472725,2000
2925,2002-01-25,Metropolis,15000000,1405032,673414,2002,-13594968,-90.63312,2000
3250,2002-01-25,A Walk to Remember,11000000,46060915,41227069,2002,35060915,318.7355909090909,2000
3371,2002-01-25,Kung Pow: Enter the Fist,10000000,17033556,16033556,2002,7033556,70.33556,2000
634,2002-02-08,Signs,70702619,408269295,227969295,2002,337566676,477.4457874042827,2000
2733,2002-02-08,The Master of Disguise,16000000,40363530,40363530,2002,24363530,152.2720625,2000
4346,2002-02-08,Martin Lawrence Live: RunTelDat,3000000,19184820,19184820,2002,16184820,539.494,2000
4576,2002-02-08,Full Frontal,2000000,3438804,2512846,2002,1438804,71.9402,2000
678,2002-02-15,Hart's War,70000000,33076815,19076815,2002,-36923185,-52.74740714285714,2000
1491,2002-02-15,John Q,36000000,102226631,71026631,2002,66226631,183.9628638888889,2000
2342,2002-02-15,Peter Pan: Return to Neverland,20000000,109862682,48430258,2002,89862682,449.31341,2000
3144,2002-02-15,Crossroads,12000000,57000000,37188667,2002,45000000,375.0,2000
3199,2002-02-15,Last Orders,12000000,2326407,2326407,2002,-9673593,-80.613275,2000
4794,2002-02-15,Super Troopers,1200000,23046142,18492362,2002,21846142,1820.5118333333335,2000
838,2002-02-19,Reign of Fire,60000000,82150183,43061982,2002,22150183,36.91697166666666,2000
855,2002-02-22,Dragonfly,60000000,30063805,30063805,2002,-29936195,-49.893658333333335,2000
1568,2002-02-22,Queen of the Damned,35000000,30307804,30307804,2002,-4692196,-13.406274285714288,2000
4137,2002-02-22,Mean Machine,4500000,92723,92723,2002,-4407277,-97.93948888888889,2000
4795,2002-02-22,Monsoon Wedding,1200000,27025600,13876974,2002,25825600,2152.1333333333337,2000
4828,2002-02-22,Sex with Strangers,1100000,247740,247740,2002,-852260,-77.47818181818181,2000
193,2002-03-05,Spider-Man,139000000,821706375,403706375,2002,682706375,491.1556654676259,2000
2762,2002-03-05,Hollywood Ending,16000000,14839383,4839383,2002,-1160617,-7.25385625,2000
3407,2002-03-05,Deuces Wild,10000000,6244618,6044618,2002,-3755382,-37.55382,2000
183,2002-03-07,Men in Black 2,140000000,441767803,190418803,2002,301767803,215.54843071428573,2000
1759,2002-03-07,Like Mike,30000000,62432423,51432423,2002,32432423,108.10807666666666,2000
2119,2002-03-07,The Powerpuff Girls,25000000,16425701,11411644,2002,-8574299,-34.297196,2000
4715,2002-03-13,Kissing Jessica Stein,1500000,9345061,7025722,2002,7845061,523.0040666666666,2000
469,2002-03-15,Showtime,85000000,78948765,37948765,2002,-6051235,-7.1191,2000
709,2002-03-15,Ice Age,65000000,386116343,176387405,2002,321116343,494.0251430769231,2000
1550,2002-03-15,Resident Evil,35000000,103787401,40119709,2002,68787401,196.53543142857143,2000
4005,2002-03-15,Y Tu Mamá También,5000000,33649881,13649881,2002,28649881,572.99762,2000
970,2002-03-22,Blade 2,54000000,154338601,81676888,2002,100338601,185.81222407407407,2000
3182,2002-03-22,Sorority Boys,12000000,12516222,10198766,2002,516222,4.30185,2000
4740,2002-03-22,Stolen Summer,1500000,119841,119841,2002,-1380159,-92.0106,2000
1111,2002-03-29,Death to Smoochy,50000000,8374062,8355815,2002,-41625938,-83.251876,2000
1127,2002-03-29,Panic Room,48000000,196308367,95308367,2002,148308367,308.97576458333333,2000
1985,2002-03-29,Clockstoppers,26000000,38788828,36985501,2002,12788828,49.187799999999996,2000
2235,2002-03-29,The Rookie,22000000,80491516,75600072,2002,58491516,265.87052727272726,2000
1416,2002-04-01,Impostor,40000000,7974607,6114237,2002,-32025393,-80.0634825,2000
562,2002-04-10,Red Dragon,78000000,206455420,92955420,2002,128455420,164.6864358974359,2000
2978,2002-04-10,Jonah: A VeggieTales Movie,14000000,25608779,25571351,2002,11608779,82.91985,2000
3212,2002-04-10,Welcome to Collinwood,12000000,4606284,378650,2002,-7393716,-61.6143,2000
793,2002-04-19,The Scorpion King,60000000,165890634,90580000,2002,105890634,176.48439,2000
1076,2002-04-19,Murder by Numbers,50000000,56643267,31874869,2002,6643267,13.286534,2000
3953,2002-04-19,My Big Fat Greek Wedding,5000000,374890034,241438208,2002,369890034,7397.80068,2000
4725,2002-04-19,Nueve Reinas,1500000,12412889,1222889,2002,10912889,727.5259333333333,2000
1399,2002-04-26,"Life, or Something Like It",40000000,14448589,14448589,2002,-25551411,-63.878527500000004,2000
2643,2002-04-26,The Salton Sea,18000000,676698,676698,2002,-17323302,-96.24056666666667,2000
2990,2002-04-26,Jason X,14000000,16951798,13121555,2002,2951798,21.084271428571427,2000
5127,2002-04-26,Dogtown and Z-Boys,400000,1600566,1293295,2002,1200566,300.1415,2000
1225,2002-05-04,Big Trouble,45000000,8488871,7262288,2002,-36511129,-81.13584222222222,2000
1256,2002-05-04,High Crimes,42000000,63781100,41543207,2002,21781100,51.8597619047619,2000
3844,2002-05-04,National Lampoon's Van Wilder,6000000,39241323,21305259,2002,33241323,554.02205,2000
3893,2002-05-04,Lucky Break,6000000,4316497,54606,2002,-1683503,-28.05838333333333,2000
274,2002-05-16,Star Wars Ep. II: Attack of the Clones,115000000,656695615,310676740,2002,541695615,471.03966521739136,2000
1945,2002-05-17,About a Boy,27000000,130759651,40803000,2002,103759651,384.2950037037037,2000
3936,2002-05-17,Harvard Man,5500000,56653,56653,2002,-5443347,-98.96994545454545,2000
4730,2002-05-17,The Believer,1500000,1840248,406035,2002,340248,22.6832,2000
2899,2002-05-22,The Importance of Being Earnest,15000000,8378141,8378141,2002,-6621859,-44.14572666666667,2000
522,2002-05-24,Spirit: Stallion of the Cimarron,80000000,106515310,73215310,2002,26515310,33.1441375,2000
1155,2002-05-24,Insomnia,46000000,113622499,67263182,2002,67622499,147.00543260869566,2000
1458,2002-05-24,Enough,38000000,50970660,39177215,2002,12970660,34.133315789473684,2000
4383,2002-05-24,Thirteen Conversations About One Thing,3000000,3705923,3287435,2002,705923,23.530766666666665,2000
4535,2002-05-29,Elling,2100000,313436,313436,2002,-1786564,-85.07447619047619,2000
690,2002-05-31,The Sum of All Fears,68000000,193500000,118471320,2002,125500000,184.55882352941177,2000
2058,2002-05-31,Undercover Brother,25000000,40796145,38230435,2002,15796145,63.184580000000004,2000
1387,2002-06-09,City by the Sea,40000000,22433915,22433915,2002,-17566085,-43.9152125,2000
3345,2002-06-09,Swimfan,10000000,34364995,28564995,2002,24364995,243.64995,2000
1616,2002-06-11,Femme Fatale,35000000,16830252,6630252,2002,-18169748,-51.91356571428572,2000
851,2002-06-12,Analyze That,60000000,54994757,32122249,2002,-5005243,-8.342071666666667,2000
2493,2002-06-12,Equilibrium,20000000,5345869,1190018,2002,-14654131,-73.27065499999999,2000
2559,2002-06-12,Adaptation,18500000,32531759,22498520,2002,14031759,75.84734594594595,2000
4270,2002-06-12,Empire,3500000,18495444,17504595,2002,14995444,428.4412571428572,2000
279,2002-06-14,Windtalkers,115000000,77628265,40914068,2002,-37371735,-32.497160869565214,2000
475,2002-06-14,Scooby-Doo,84000000,276294164,153294164,2002,192294164,228.9216238095238,2000
782,2002-06-14,The Bourne Identity,60000000,214357371,121468960,2002,154357371,257.262285,2000
3203,2002-06-14,The Dangerous Lives of Altar Boys,12000000,1779284,1779284,2002,-10220716,-85.17263333333334,2000
324,2002-06-21,Minority Report,102000000,358824714,132024714,2002,256824714,251.78893529411766,2000
494,2002-06-21,Lilo & Stitch,80000000,245800000,145771527,2002,165800000,207.24999999999997,2000
2779,2002-06-21,Juwanna Mann,15600000,13771817,13571817,2002,-1828183,-11.719121794871795,2000
3917,2002-06-21,Sunshine State,5600000,3281898,3064356,2002,-2318102,-41.39467857142857,2000
1014,2002-06-28,Mr. Deeds,50000000,171269535,126293452,2002,121269535,242.53906999999998,2000
3379,2002-06-28,Hey Arnold! The Movie,10000000,13684949,13684949,2002,3684949,36.84949,2000
5187,2002-06-28,Lovely and Amazing,250000,4613482,4210379,2002,4363482,1745.3928,2000
672,2002-07-06,Bad Company,70000000,69157016,30157016,2002,-842984,-1.204262857142857,2000
1939,2002-07-06,The Divine Secrets of the Ya-Ya Sisterhood,27000000,73826768,69586544,2002,46826768,173.43247407407407,2000
1447,2002-07-08,Spy Kids 2: The Island of Lost Dreams,38000000,119721296,85846296,2002,81721296,215.05604210526315,2000
3626,2002-07-08,The Good Girl,8000000,16585503,14018296,2002,8585503,107.31878749999998,2000
1817,2002-07-17,Eight Legged Freaks,30000000,36722311,17266505,2002,6722311,22.407703333333334,2000
264,2002-07-19,Stuart Little 2,120000000,166000000,64956806,2002,46000000,38.333333333333336,2000
429,2002-07-19,K-19: The Widowmaker,90000000,65716126,35168966,2002,-24283874,-26.98208222222222,2000
5170,2002-07-19,Ayurveda: Art of Being,300000,2066892,16892,2002,1766892,588.9639999999999,2000
5272,2002-07-19,Tadpole,150000,3270128,2891288,2002,3120128,2080.0853333333334,2000
759,2002-07-25,Austin Powers in Goldmember,63000000,292738626,213117789,2002,229738626,364.6644857142857,2000
2419,2002-07-26,The Country Bears,20000000,16988996,16988996,2002,-3011004,-15.055019999999999,2000
468,2002-08-02,Collateral Damage,85000000,78353508,40048332,2002,-6646492,-7.819402352941177,2000
679,2002-08-02,Rollerball,70000000,25852508,18990542,2002,-44147492,-63.06784571428572,2000
2816,2002-08-02,Big Fat Liar,15000000,52461017,47811275,2002,37461017,249.7401133333333,2000
529,2002-08-03,The Time Machine,80000000,98983590,56684819,2002,18983590,23.729487499999998,2000
2979,2002-08-03,All About the Benjamins,14000000,25873145,25482931,2002,11873145,84.80817857142857,2000
3687,2002-08-03,Men with Brooms,7500000,4239767,4239767,2002,-3260233,-43.469773333333336,2000
1046,2002-08-05,Unfaithful,50000000,119114494,52752475,2002,69114494,138.22898800000002,2000
1272,2002-08-11,8 Mile,41000000,245768384,116724075,2002,204768384,499.4350829268293,2000
3021,2002-08-11,Far From Heaven,13500000,29027914,15901849,2002,15527914,115.02158518518519,2000
364,2002-08-16,The Adventures of Pluto Nash,100000000,7094995,4411102,2002,-92905005,-92.905005,2000
1777,2002-08-16,Blue Crush,30000000,51618420,40118420,2002,21618420,72.06139999999999,2000
2128,2002-08-16,Possession,25000000,14805812,10103647,2002,-10194188,-40.776752,2000
3147,2002-08-21,One Hour Photo,12000000,52223306,31597131,2002,40223306,335.19421666666665,2000
1874,2002-08-23,Serving Sara,29000000,20146150,16930185,2002,-8853850,-30.53051724137931,2000
2443,2002-08-23,Undisputed,20000000,12398628,12398628,2002,-7601372,-38.006859999999996,2000
1407,2002-08-30,FearDotCom,40000000,13208023,13208023,2002,-26791977,-66.9799425,2000
640,2002-09-08,xXx,70000000,267200000,141930000,2002,197200000,281.7142857142857,2000
1086,2002-09-08,Blood Work,50000000,26199517,26199517,2002,-23800483,-47.600966,2000
4984,2002-09-08,Pandora's Box,800000,881950,881950,2002,81950,10.24375,2000
2111,2002-09-13,Stealing Harvard,25000000,13973532,13973532,2002,-11026468,-44.105872000000005,2000
3128,2002-09-13,Barbershop,12000000,77063461,75781642,2002,65063461,542.1955083333334,2000
3537,2002-09-13,Igby Goes Down,9000000,4777465,4777465,2002,-4222535,-46.91705555555556,2000
3693,2002-09-13,Betty Fisher et autres histoires,7500000,206400,206400,2002,-7293600,-97.248,2000
681,2002-09-20,Ballistic: Ecks vs. Sever,70000000,14294842,14294842,2002,-55705158,-79.57879714285714,2000
968,2002-09-20,Eye See You,55000000,1807990,79161,2002,-53192010,-96.71274545454546,2000
1592,2002-09-20,The Four Feathers,35000000,29882645,18306166,2002,-5117355,-14.621014285714285,2000
1840,2002-09-20,Trapped,30000000,6916869,6916869,2002,-23083131,-76.94377,2000
2547,2002-09-20,Sen to Chihiro no Kamikakushi,19000000,274949886,10049886,2002,255949886,1347.1046631578947,2000
3338,2002-09-20,The Banger Sisters,10000000,38067218,30306281,2002,28067218,280.67218,2000
3641,2002-09-20,8 femmes,8000000,42376425,3076425,2002,34376425,429.7053125,2000
4198,2002-09-20,Secretary,4000000,9413956,4046737,2002,5413956,135.3489,2000
826,2002-09-27,The Tuxedo,60000000,104429625,50586000,2002,44429625,74.049375,2000
1445,2002-09-27,Sweet Home Alabama,38000000,182365114,127214072,2002,144365114,379.9081947368421,2000
2299,2002-09-27,Moonlight Mile,21000000,6830957,6830957,2002,-14169043,-67.47163333333333,2000
2785,2002-09-27,Wasabi,15300000,7000000,81525,2002,-8300000,-54.248366013071895,2000
4952,2002-09-27,Charly,950000,814666,814666,2002,-135334,-14.245684210526315,2000
3049,2002-10-05,The New Guy,13000000,28972187,28972187,2002,15972187,122.86297692307693,2000
5240,2002-10-05,The Business of Fancy Dancing,200000,174682,174682,2002,-25318,-12.659,2000
5241,2002-10-05,Hybrid,200000,162605,162605,2002,-37395,-18.6975,2000
1125,2002-10-18,The Ring,48000000,248218486,129094024,2002,200218486,417.12184583333334,2000
1959,2002-10-18,Formula 51,27000000,5204007,5204007,2002,-21795993,-80.7259,2000
2125,2002-10-18,Abandon,25000000,12219367,10719367,2002,-12780633,-51.122532,2000
3756,2002-10-18,Auto Focus,7000000,2703821,2062066,2002,-4296179,-61.373985714285716,2000
4369,2002-10-18,Real Women Have Curves,3000000,7777790,5853194,2002,4777790,159.25966666666667,2000
2377,2002-10-25,Ghost Ship,20000000,68349884,30113491,2002,48349884,241.74942000000001,2000
2938,2002-10-25,All the Queen's Men,15000000,22723,22723,2002,-14977277,-99.84851333333333,2000
3155,2002-10-25,Frida,12000000,56131239,25885000,2002,44131239,367.760325,2000
3551,2002-10-25,All or Nothing,9000000,184255,184255,2002,-8815745,-97.95272222222222,2000
3962,2002-10-25,Jackass: The Movie,5000000,79282312,64282312,2002,74282312,1485.64624,2000
4977,2002-10-25,Time Changer,825000,1500711,1500711,2002,675711,81.90436363636364,2000
2588,2002-11-01,Orange County,18000000,43308707,41059716,2002,25308707,140.60392777777778,2000
2095,2002-11-10,Punch-Drunk Love,25000000,24591031,17791031,2002,-408969,-1.635876,2000
2292,2002-11-10,The Transporter,21000000,43928932,25296447,2002,22928932,109.18539047619046,2000
2748,2002-11-10,White Oleander,16000000,21657770,16357770,2002,5657770,35.3610625,2000
2863,2002-11-10,Tuck Everlasting,15000000,19344615,19161999,2002,4344615,28.9641,2000
2883,2002-11-10,Knockaround Guys,15000000,12419700,11660180,2002,-2580300,-17.202,2000
3445,2002-11-10,Swept Away,10000000,598645,598645,2002,-9401355,-94.01355,2000
3608,2002-11-10,Brown Sugar,8000000,28315272,27362712,2002,20315272,253.9409,2000
4194,2002-11-10,The Rules of Attraction,4000000,11799060,6525762,2002,7799060,194.9765,2000
4341,2002-11-10,Bowling for Columbine,3000000,58240487,21576018,2002,55240487,1841.3495666666665,2000
326,2002-11-15,Harry Potter and the Chamber of Secrets,100000000,878979634,261987880,2002,778979634,778.9796339999999,2000
2101,2002-11-15,Half Past Dead,25000000,19233280,15567860,2002,-5766720,-23.06688,2000
2781,2002-11-15,Ararat,15500000,1693000,1693000,2002,-13807000,-89.07741935483871,2000
4668,2002-11-15,El crimen de padre Amaro,1800000,5719000,5719000,2002,3919000,217.72222222222223,2000
5001,2002-11-15,Interview with the Assassin,750000,47329,47329,2002,-702671,-93.68946666666666,2000
5149,2002-11-15,Revolution#9,350000,9118,9118,2002,-340882,-97.39485714285713,2000
180,2002-11-22,Die Another Day,142000000,431942139,160942139,2002,289942139,204.18460492957746,2000
2439,2002-11-22,The Quiet American,20000000,26348203,12987647,2002,6348203,31.741015,2000
3100,2002-11-22,The Emperor's Club,12500000,16193713,14060950,2002,3693713,29.549704,2000
3331,2002-11-22,Friday After Next,10000000,33526835,33253609,2002,23526835,235.26835,2000
358,2002-11-27,Treasure Planet,100000000,91800000,38120554,2002,-8200000,-8.200000000000001,2000
1148,2002-11-27,Solaris,47000000,14970038,14970038,2002,-32029962,-68.14885531914894,2000
1418,2002-11-27,Extreme Ops,40000000,12624471,4835968,2002,-27375529,-68.4388225,2000
2695,2002-11-27,Wes Craven Presents: They,17000000,16140842,12840842,2002,-859158,-5.053870588235294,2000
3747,2002-11-29,Rabbit-Proof Fence,7000000,16866928,6199600,2002,9866928,140.95611428571428,2000
1180,2002-12-04,Changing Lanes,45000000,66790248,66790248,2002,21790248,48.42277333333334,2000
1243,2002-12-04,The Sweetest Thing,43000000,63078756,24430272,2002,20078756,46.69478139534884,2000
3267,2002-12-04,Frailty,11000000,19947280,13110448,2002,8947280,81.3389090909091,2000
505,2002-12-07,Road to Perdition,80000000,183354514,104054514,2002,103354514,129.1931425,2000
2840,2002-12-07,Halloween: Resurrection,15000000,37659652,30259652,2002,22659652,151.06434666666667,2000
3096,2002-12-07,Crocodile Hunter: Collision Course,12500000,33436931,28436931,2002,20936931,167.495448,2000
5066,2002-12-07,Never Again,500000,308793,307631,2002,-191207,-38.2414,2000
837,2002-12-13,Star Trek: Nemesis,60000000,67312826,43254409,2002,7312826,12.188043333333333,2000
921,2002-12-13,Maid in Manhattan,55000000,163838217,93932896,2002,108838217,197.88766727272727,2000
1737,2002-12-13,About Schmidt,30000000,107054484,65005217,2002,77054484,256.84828,2000
2335,2002-12-13,Drumline,20000000,56398162,56398162,2002,36398162,181.99080999999998,2000
4923,2002-12-13,The Jimmy Show,1000000,703,703,2002,-999297,-99.9297,2000
384,2002-12-18,The Lord of the Rings: The Two Towers,94000000,934699645,342548984,2002,840699645,894.3613244680851,2000
3098,2002-12-19,Antwone Fisher,12500000,23367586,21078145,2002,10867586,86.940688,2000
4118,2002-12-19,25th Hour,4500000,25344490,13084595,2002,20844490,463.2108888888889,2000
369,2002-12-20,Gangs of New York,97000000,183124621,77730500,2002,86124621,88.78826907216495,2000
791,2002-12-20,Two Weeks Notice,60000000,199043309,93354918,2002,139043309,231.73884833333332,2000
2055,2002-12-20,The Wild Thornberrys Movie,25000000,60694737,40108697,2002,35694737,142.77894799999999,2000
3684,2002-12-20,Narc,7500000,11843260,10465659,2002,4343260,57.910133333333334,2000
3886,2002-12-20,Morvern Callar,6000000,267194,267194,2002,-5732806,-95.54676666666667,2000
987,2002-12-25,Catch Me if You Can,52000000,355612291,164606800,2002,303612291,583.8697903846154,2000
1228,2002-12-25,Pinocchio,45000000,31681811,3681811,2002,-13318189,-29.595975555555555,2000
1564,2002-12-27,The Pianist,35000000,111854182,32519322,2002,76854182,219.58337714285716,2000
1706,2002-12-27,Chicago,30000000,306771047,170687518,2002,276771047,922.5701566666667,2000
2052,2002-12-27,The Hours,25000000,97030468,41675994,2002,72030468,288.121872,2000
3433,2002-12-27,Nicholas Nickleby,10000000,1562800,1562800,2002,-8437200,-84.372,2000
4230,2002-12-27,Sonny,4000000,17639,17639,2002,-3982361,-99.559025,2000
4899,2002-12-30,Love Lisa,1000000,213137,213137,2002,-786863,-78.6863,2000
1875,2002-12-31,Confessions of a Dangerous Mind,29000000,33013805,16007718,2002,4013805,13.840706896551724,2000
103,2003-01-07,Terminator 3: Rise of the Machines,170000000,433058296,150358296,2003,263058296,154.74017411764706,2000
917,2003-01-08,American Wedding,55000000,126425115,104354205,2003,71425115,129.86384545454547,2000
975,2003-01-08,Gigli,54000000,7126002,6087542,2003,-46873998,-86.80369999999999,2000
809,2003-01-17,Kangaroo Jack,60000000,90723216,66723216,2003,30723216,51.20536,2000
2424,2003-01-17,A Guy Thing,20000000,17430594,15543862,2003,-2569406,-12.84703,2000
4313,2003-01-17,Cidade de Deus,3300000,32059295,7563397,2003,28759295,871.4937878787879,2000
3011,2003-01-24,Amen,14000000,274299,274299,2003,-13725701,-98.04072142857143,2000
3716,2003-01-24,Darkness Falls,7000000,47289758,32539681,2003,40289758,575.5679714285714,2000
1980,2003-01-31,Final Destination 2,26000000,90396664,46896664,2003,64396664,247.67947692307692,2000
3274,2003-01-31,The Guru,11000000,24150550,3051221,2003,13150550,119.55045454545454,2000
5061,2003-01-31,The R.M.,500000,1111615,1111615,2003,611615,122.32300000000001,2000
1845,2003-02-04,The Good Thief,30000000,6460758,3517797,2003,-23539242,-78.46414,2000
237,2003-02-05,X2,125000000,407711549,214949694,2003,282711549,226.1692392,2000
2820,2003-02-05,The Lizzie McGuire Movie,15000000,55534455,42734455,2003,40534455,270.22970000000004,2000
3439,2003-02-05,Owning Mahowny,10000000,1011054,1011054,2003,-8988946,-89.88946,2000
4890,2003-02-05,Blue Car,1000000,475367,464126,2003,-524633,-52.463300000000004,2000
860,2003-02-07,Sinbad: Legend of the Seven Seas,60000000,80767884,26483452,2003,20767884,34.61314,2000
2016,2003-02-07,"Legally Blonde 2: Red, White & Blonde",25000000,125339088,90639088,2003,100339088,401.356352,2000
507,2003-02-14,Daredevil,80000000,182782518,102543518,2003,102782518,128.4781475,2000
2343,2003-02-14,The Jungle Book 2,20000000,140122225,47901582,2003,120122225,600.611125,2000
3772,2003-02-14,Gerry,7000000,719699,254683,2003,-6280301,-89.71858571428571,2000
4886,2003-02-14,All the Real Girls,1000000,703020,549666,2003,-296980,-29.698,2000
960,2003-02-21,Gods and Generals,55000000,12923936,12882934,2003,-42076064,-76.50193454545455,2000
1098,2003-02-21,The Life of David Gale,50000000,28920188,19694635,2003,-21079812,-42.159624,2000
2166,2003-02-21,Old School,24000000,86765463,75155000,2003,62765463,261.5227625,2000
2893,2003-02-21,Dark Blue,15000000,12262065,9237470,2003,-2737935,-18.2529,2000
2066,2003-02-28,Cradle 2 the Grave,25000000,56434942,34657731,2003,31434942,125.739768,2000
3431,2003-02-28,Spider,10000000,1641788,1641788,2003,-8358212,-83.58212,2000
4211,2003-02-28,Poolhall Junkies,4000000,563711,563711,2003,-3436289,-85.907225,2000
1063,2003-03-10,Out of Time,50000000,55489826,41083108,2003,5489826,10.979652,2000
2323,2003-03-10,School of Rock,20000000,131945303,81261177,2003,111945303,559.7265150000001,2000
3909,2003-03-10,Foolproof,5800000,421021,230312,2003,-5378979,-92.74101724137931,2000
3932,2003-03-10,Wonderland,5500000,1060512,1060512,2003,-4439488,-80.71796363636363,2000
4484,2003-03-10,Sur Le Seuil,2500000,2013052,2013052,2003,-486948,-19.47792,2000
5053,2003-03-10,The Station Agent,500000,9470209,5801558,2003,8970209,1794.0418000000002,2000
5294,2003-03-10,The Work and the Story,103000,16137,16137,2003,-86863,-84.33300970873786,2000
949,2003-03-14,The Hunted,55000000,47213095,34234008,2003,-7786905,-14.15800909090909,2000
2044,2003-03-14,Agent Cody Banks,25000000,58240458,47545060,2003,33240458,132.96183200000002,2000
2469,2003-03-14,Willard,20000000,6882696,6882696,2003,-13117304,-65.58652000000001,2000
4130,2003-03-14,Spun,4500000,1022649,410241,2003,-3477351,-77.27446666666667,2000
695,2003-03-21,Dreamcatcher,68000000,75685268,33685268,2003,7685268,11.301864705882354,2000
2898,2003-03-21,Boat Trip,15000000,14933713,8586376,2003,-66287,-0.4419133333333334,2000
3905,2003-03-21,L'auberge espagnole,5900000,3895664,3895664,2003,-2004336,-33.97179661016949,2000
4809,2003-03-21,Down & Out with the Dolls,1200000,58936,58936,2003,-1141064,-95.08866666666667,2000
473,2003-03-28,The Core,85000000,74132631,31111260,2003,-10867369,-12.78514,2000
1084,2003-03-28,Basic,50000000,42598498,26599248,2003,-7401502,-14.803004,2000
1507,2003-03-28,Head of State,35200000,38283765,37788228,2003,3083765,8.760696022727272,2000
4982,2003-03-28,Raising Victor Vargas,800000,2900578,2073984,2003,2100578,262.57225,2000
4800,2003-04-03,The Day the Earth Stood Still,1200000,3700000,3700000,2003,2500000,208.33333333333334,2000
1498,2003-04-04,A Man Apart,36000000,43797731,26500000,2003,7797731,21.660363888888888,2000
2063,2003-04-04,What a Girl Wants,25000000,35990505,35990505,2003,10990505,43.96202,2000
3249,2003-04-04,Phone Booth,11000000,97837138,46566212,2003,86837138,789.4285272727273,2000
4390,2003-04-04,DysFunkTional Family,3000000,2255000,2255000,2003,-745000,-24.833333333333332,2000
3674,2003-04-07,Swimming Pool,7800000,24021282,10130108,2003,16221282,207.96515384615387,2000
996,2003-04-16,Bulletproof Monk,52000000,23010607,23010607,2003,-28989393,-55.748832692307694,2000
3534,2003-04-16,Chasing Papi,9000000,12657377,6126237,2003,3657377,40.63752222222222,2000
3848,2003-04-16,A Mighty Wind,6000000,18504539,17583468,2003,12504539,208.40898333333337,2000
1919,2003-04-18,Winged Migration,28000000,39134983,11689053,2003,11134983,39.76779642857143,2000
2330,2003-04-18,Holes,20000000,71232214,67383924,2003,51232214,256.16107,2000
2832,2003-04-18,Malibu's Most Wanted,15000000,34499204,34308901,2003,19499204,129.99469333333334,2000
4135,2003-04-18,Lilja 4-ever,4500000,4556982,181655,2003,56982,1.2662666666666667,2000
1898,2003-04-25,Identity,28000000,82183683,52131264,2003,54183683,193.51315357142857,2000
2508,2003-04-25,People I Know,20000000,5694213,121972,2003,-14305787,-71.528935,2000
2664,2003-04-25,City of Ghosts,17500000,325491,325491,2003,-17174509,-98.14005142857143,2000
2882,2003-04-25,Confidence,15000000,12212417,12212417,2003,-2787583,-18.583886666666665,2000
2931,2003-04-25,Steal (Canadian Release),15000000,220944,220944,2003,-14779056,-98.52704,2000
4199,2003-04-25,The Real Cancun,4000000,3816594,3816594,2003,-183406,-4.5851500000000005,2000
1613,2003-05-09,The Order,35000000,11559747,7659747,2003,-23440253,-66.97215142857142,2000
2690,2003-05-09,Dickie Roberts: Former Child Star,17000000,23734486,22734486,2003,6734486,39.614623529411766,2000
154,2003-05-11,The Matrix Revolutions,150000000,427300260,139270910,2003,277300260,184.86684,2000
188,2003-05-12,The Last Samurai,140000000,456810575,111110575,2003,316810575,226.29326785714287,2000
2591,2003-05-12,Honey,18000000,62646763,30272254,2003,44646763,248.0375722222222,2000
4830,2003-05-14,Dracula: Pages from a Virgin's Diary,1100000,81371,39659,2003,-1018629,-92.60263636363636,2000
139,2003-05-15,The Matrix Reloaded,150000000,738576929,281553689,2003,588576929,392.3846193333334,2000
485,2003-05-23,Bruce Almighty,81000000,484468608,242704995,2003,403468608,498.1093925925926,2000
382,2003-05-30,Finding Nemo,94000000,936429370,380529370,2003,842429370,896.2014574468085,2000
785,2003-05-30,The Italian Job,60000000,176262839,106126012,2003,116262839,193.7713983333333,2000
3373,2003-05-30,Wrong Turn,10000000,28649556,15417771,2003,18649556,186.49556,2000
569,2003-06-06,2 Fast 2 Furious,76000000,236410607,127120058,2003,160410607,211.06658815789473,2000
3931,2003-06-06,Mambo Italiano,5500000,6148823,3031801,2003,648823,11.796781818181818,2000
4150,2003-06-06,Whale Rider,4300000,39374600,20779666,2003,35074600,815.6883720930233,2000
1967,2003-06-08,Freaky Friday,26000000,160822438,110222438,2003,134822438,518.5478384615385,2000
609,2003-06-13,Hollywood Homicide,75000000,50409753,30207785,2003,-24590247,-32.786996,2000
1800,2003-06-13,Dumb and Dumberer: When Harry Met Lloyd,30000000,26214846,26214846,2003,-3785154,-12.61718,2000
2056,2003-06-13,Rugrats Go Wild,25000000,55443032,39402572,2003,30443032,121.772128,2000
3774,2003-06-13,The Heart of Me,7000000,196067,196067,2003,-6803933,-97.19904285714286,2000
4064,2003-06-13,Tycoon,5000000,121016,121016,2003,-4878984,-97.57968,2000
197,2003-06-20,Hulk,137000000,245229234,132177234,2003,108229234,78.99944087591241,2000
1826,2003-06-20,Alex & Emma,30000000,15358583,14208384,2003,-14641417,-48.804723333333335,2000
3192,2003-06-20,From Justin to Kelly,12000000,4922166,4922166,2003,-7077834,-58.981950000000005,2000
3547,2003-06-20,The Legend of Suriyothai,9000000,454255,454255,2003,-8545745,-94.95272222222222,2000
260,2003-06-27,Charlie's Angels: Full Throttle,120000000,227200000,100814328,2003,107200000,89.33333333333333,2000
3603,2003-06-27,28 Days Later…,8000000,82955633,45064915,2003,74955633,936.9454125000001,2000
1016,2003-07-02,How to Lose a Guy in 10 Days,50000000,178890782,105807520,2003,128890782,257.781564,2000
1038,2003-07-02,Shanghai Knights,50000000,88316835,60470220,2003,38316835,76.63367,2000
4681,2003-07-02,May,1750000,634803,145540,2003,-1115197,-63.725542857142855,2000
600,2003-07-03,Tears of the Sun,75000000,85632458,43632458,2003,10632458,14.176610666666667,2000
2313,2003-07-03,Bringing Down the House,20000000,164675402,132675402,2003,144675402,723.37701,2000
3811,2003-07-03,Nowhere in Africa,6500000,6173485,6173485,2003,-326515,-5.023307692307692,2000
3941,2003-07-03,Irreversible,5400000,8133256,792200,2003,2733256,50.61585185185186,2000
1184,2003-07-11,Love Actually,45000000,247950247,59472278,2003,202950247,451.0005488888889,2000
1662,2003-07-11,Elf,32000000,220236410,173398518,2003,188236410,588.23878125,2000
219,2003-07-18,Bad Boys II,130000000,273271982,138540870,2003,143271982,110.20921692307692,2000
1203,2003-07-18,Johnny English,45000000,163126676,28013509,2003,118126676,262.50372444444446,2000
2752,2003-07-18,How to Deal,16000000,14108518,14108518,2003,-1891482,-11.8217625,2000
3394,2003-07-18,Dirty Pretty Things,10000000,14156753,8112414,2003,4156753,41.567530000000005,2000
4607,2003-07-18,This Thing of Ours,2000000,37227,37227,2003,-1962773,-98.13865,2000
3692,2003-07-24,Masked and Anonymous,7500000,555335,533344,2003,-6944665,-92.59553333333334,2000
420,2003-07-25,Lara Croft: Tomb Raider: The Cradle of Life,90000000,157092943,65653758,2003,67092943,74.54771444444445,2000
438,2003-07-25,Seabiscuit,86000000,148715342,120277854,2003,62715342,72.92481627906977,2000
1287,2003-07-25,Spy Kids 3-D: Game Over,40000000,167851995,111760631,2003,127851995,319.62998749999997,2000
2930,2003-07-25,Buffalo Soldiers,15000000,353743,353743,2003,-14646257,-97.64171333333334,2000
4222,2003-07-25,Mondays in the Sun,4000000,146402,146402,2003,-3853598,-96.33995,2000
645,2003-08-08,S.W.A.T.,70000000,207154748,116877597,2003,137154748,195.93535428571428,2000
1723,2003-08-10,Mystic River,30000000,156822020,90135191,2003,126822020,422.7400666666667,2000
1975,2003-08-15,Open Range,26000000,68613992,58331254,2003,42613992,163.89996923076924,2000
2019,2003-08-15,Freddy vs. Jason,25000000,114576403,82622655,2003,89576403,358.305612,2000
4564,2003-08-15,American Splendor,2000000,8685632,6003587,2003,6685632,334.2816,2000
4567,2003-08-20,Thirteen,2000000,9505996,4601043,2003,7505996,375.2998,2000
1274,2003-08-22,The Medallion,41000000,22108977,22108977,2003,-18891023,-46.075665853658535,2000
2492,2003-08-22,Marci X,20000000,1646664,1646664,2003,-18353336,-91.76668,2000
2984,2003-08-22,My Boss's Daughter,14000000,15549702,15549702,2003,1549702,11.0693,2000
4895,2003-08-22,The Battle of Shaker Heights,1000000,839145,280351,2003,-160855,-16.0855,2000
2064,2003-08-29,Jeepers Creepers II,25000000,119923801,35623801,2003,94923801,379.695204,2000
4053,2003-08-29,Party Monster,5000000,894030,742898,2003,-4105970,-82.1194,2000
5068,2003-08-29,Civil Brand,500000,254293,254293,2003,-245707,-49.141400000000004,2000
786,2003-09-05,Daddy Day Care,60000000,164285587,104148781,2003,104285587,173.80931166666667,2000
4024,2003-09-05,Les invasions barbares,5000000,25913869,8460000,2003,20913869,418.27738,2000
234,2003-09-07,Pirates of the Caribbean: The Curse of the Black Pearl,125000000,634954103,305411224,2003,509954103,407.96328239999997,2000
1774,2003-09-19,Secondhand Lions,30000000,47902566,42070939,2003,17902566,59.675219999999996,2000
2241,2003-09-19,Underworld,22000000,95708457,51970690,2003,73708457,335.0384409090909,2000
2637,2003-09-19,Anything Else,18000000,13203044,3203044,2003,-4796956,-26.649755555555554,2000
4876,2003-09-19,Bubba Ho-Tep,1000000,1492895,1239183,2003,492895,49.289500000000004,2000
463,2003-09-26,The Rundown,85000000,80831893,47641743,2003,-4168107,-4.903655294117646,2000
1412,2003-09-26,Duplex,40000000,10070651,9652000,2003,-29929349,-74.82337249999999,2000
1618,2003-09-26,Luther,35000000,32738814,5781086,2003,-2261186,-6.460531428571429,2000
2584,2003-09-26,Under the Tuscan Sun,18000000,57490024,43601508,2003,39490024,219.3890222222222,2000
3272,2003-09-26,The Gospel of John,11000000,4234355,4068087,2003,-6765645,-61.505863636363635,2000
4489,2003-09-26,My Life Without Me,2500000,12267275,432360,2003,9767275,390.691,2000
2533,2003-10-01,Just Married,19000000,101564935,56127162,2003,82564935,434.5522894736842,2000
5079,2003-10-01,The Slaughter Rule,500000,13134,13134,2003,-486866,-97.3732,2000
847,2003-10-10,Intolerable Cruelty,60000000,121327628,35327628,2003,61327628,102.21271333333333,2000
929,2003-10-10,Kill Bill: Volume 1,55000000,176469428,70098138,2003,121469428,220.85350545454548,2000
2683,2003-10-10,Good Boy!,17000000,45312217,37667746,2003,28312217,166.54245294117646,2000
3738,2003-10-10,The House of the Dead,7000000,13767816,10199354,2003,6767816,96.68308571428571,2000
3887,2003-10-10,The Flower of Evil,6000000,181798,181798,2003,-5818202,-96.97003333333333,2000
657,2003-10-12,Big Fish,70000000,123954323,66432867,2003,53954323,77.07760428571429,2000
2708,2003-10-17,Veronica Guerin,17000000,9438074,1569918,2003,-7561926,-44.48191764705882,2000
3511,2003-10-17,The Texas Chainsaw Massacre,9000000,107967319,80571655,2003,98967319,1099.636877777778,2000
5159,2003-10-17,Pieces of April,300000,3571253,2528664,2003,3271253,1090.4176666666667,2000
3195,2003-10-22,In the Cut,12000000,23693646,4717455,2003,11693646,97.44705,2000
877,2003-10-24,Beyond Borders,60000000,11427090,4426297,2003,-48572910,-80.95485,2000
1163,2003-10-24,Scary Movie 3,45000000,155200000,110000082,2003,110200000,244.88888888888889,2000
1541,2003-10-24,Radio,35000000,53293628,52333738,2003,18293628,52.267508571428564,2000
3651,2003-10-24,The Singing Detective,8000000,524747,336456,2003,-7475253,-93.4406625,2000
4392,2003-10-24,Elephant,3000000,10051516,1266955,2003,7051516,235.05053333333333,2000
3876,2003-10-31,Shattered Glass,6000000,3456602,2207975,2003,-2543398,-42.389966666666666,2000
902,2003-11-04,Anger Management,56000000,195660942,135560942,2003,139660942,249.3945392857143,2000
3736,2003-11-04,"House of 1,000 Corpses",7000000,17005466,12634962,2003,10005466,142.93522857142858,2000
4988,2003-11-04,The Young Unknowns,800000,58163,58163,2003,-741837,-92.729625,2000
5188,2003-11-04,Better Luck Tomorrow,250000,3809226,3802390,2003,3559226,1423.6904,2000
564,2003-11-07,The League of Extraordinary Gentlemen,78000000,179265204,66465204,2003,101265204,129.8271846153846,2000
4652,2003-11-07,Northfork,1900000,1445140,1420578,2003,-454860,-23.94,2000
5077,2003-11-07,The Journey,500000,19800,19800,2003,-480200,-96.04,2000
204,2003-11-14,Master and Commander: The Far Side of the World,135000000,212912137,93926386,2003,77912137,57.71269407407408,2000
545,2003-11-14,Looney Tunes: Back in Action,80000000,54540662,20950820,2003,-25459338,-31.824172499999996,2000
5157,2003-11-14,Tupac Resurrection,300000,7808524,7718961,2003,7508524,2502.8413333333333,2000
309,2003-11-21,The Cat in the Hat,109000000,133818283,101018283,2003,24818283,22.769066972477063,2000
1323,2003-11-21,Gothika,40000000,141484812,59588068,2003,101484812,253.71203000000003,2000
2420,2003-11-21,21 Grams,20000000,59667625,16248701,2003,39667625,198.33812500000002,2000
416,2003-11-26,The Haunted Mansion,90000000,155750628,75817994,2003,65750628,73.05625333333333,2000
547,2003-11-26,Timeline,80000000,26703184,19480739,2003,-53296816,-66.62102,2000
745,2003-11-26,The Missing,65000000,38253433,26900336,2003,-26746567,-41.148564615384615,2000
2575,2003-11-26,Bad Santa,18000000,77147031,60060328,2003,59147031,328.5946166666667,2000
4188,2003-11-26,The Cooler,4000000,11131455,8291572,2003,7131455,178.286375,2000
4560,2003-11-26,Les Triplettes de Belleville,2000000,17403168,7301288,2003,15403168,770.1584,2000
3915,2003-12-03,Bend it Like Beckham,5600000,74566042,32543449,2003,68966042,1231.5364642857141,2000
1868,2003-12-09,Once Upon a Time in Mexico,29000000,97413527,56330657,2003,68413527,235.90871379310343,2000
4164,2003-12-09,Lost in Translation,4000000,117085297,44585453,2003,113085297,2827.132425,2000
4581,2003-12-09,"The Book of Mormon Movie, Volume 1: The Journey",2000000,1660865,1660865,2003,-339135,-16.95675,2000
4708,2003-12-09,Cabin Fever,1500000,30351664,21158188,2003,28851664,1923.4442666666666,2000
501,2003-12-12,Something's Gotta Give,80000000,266685242,124685242,2003,186685242,233.3565525,2000
951,2003-12-12,Stuck On You,55000000,63537164,33832741,2003,8537164,15.522116363636362,2000
1963,2003-12-12,The Statement,27000000,1545064,765637,2003,-25454936,-94.27754074074073,2000
3178,2003-12-12,Girl with a Pearl Earring,12000000,43281552,11634362,2003,31281552,260.6796,2000
383,2003-12-17,The Lord of the Rings: The Return of the King,94000000,1141403341,377845905,2003,1047403341,1114.2588734042554,2000
729,2003-12-19,Mona Lisa Smile,65000000,141205169,63803100,2003,76205169,117.23872153846153,2000
2721,2003-12-19,House of Sand and Fog,16500000,16157923,13005485,2003,-342077,-2.0731939393939394,2000
3336,2003-12-19,Calendar Girls,10000000,93074616,31011616,2003,83074616,830.74616,2000
4777,2003-12-19,The Hebrew Hammer,1300000,90213,77755,2003,-1209787,-93.06053846153847,2000
3971,2003-12-24,Monster,5000000,64240813,34469210,2003,59240813,1184.81626,2000
355,2003-12-25,Peter Pan,100000000,95255485,48417850,2003,-4744515,-4.744515,2000
511,2003-12-25,Cold Mountain,80000000,165173909,95632614,2003,85173909,106.46738625,2000
822,2003-12-25,Paycheck,60000000,98819789,53789313,2003,38819789,64.69964833333334,2000
1282,2003-12-25,Cheaper by the Dozen,40000000,190212113,138614544,2003,150212113,375.5302825,2000
2918,2003-12-25,The Company,15000000,3396508,2281585,2003,-11603492,-77.35661333333333,2000
4236,2003-12-31,Nothing,4000000,63180,0,2003,-3936820,-98.4205,2000
5386,2004-01-01,The Mongol King,7000,900,900,2004,-6100,-87.14285714285714,2000
2211,2004-01-09,Vanity Fair,23000000,19123851,16123851,2004,-3876149,-16.852821739130437,2000
580,2004-01-10,Shark Tale,75000000,371917043,161412000,2004,296917043,395.8893906666667,2000
806,2004-01-10,Ladder 49,60000000,102332848,74541707,2004,42332848,70.55474666666667,2000
2265,2004-01-10,I Heart Huckabees,22000000,20034713,12784713,2004,-1965287,-8.933122727272726,2000
4368,2004-01-10,Woman Thou Art Loosed,3000000,6879730,6879730,2004,3879730,129.32433333333333,2000
1250,2004-01-16,Along Came Polly,42000000,173044410,88073507,2004,131044410,312.01050000000004,2000
1389,2004-01-16,Torque,40000000,46176322,21176322,2004,6176322,15.440805,2000
3405,2004-01-16,Teacher's Pet: The Movie,10000000,6491969,6491969,2004,-3508031,-35.08031,2000
2184,2004-01-23,Win a Date with Tad Hamilton!,24000000,16980098,16980098,2004,-7019902,-29.249591666666667,2000
3037,2004-01-23,The Butterfly Effect,13000000,95638592,57924679,2004,82638592,635.6814769230768,2000
4568,2004-01-23,Touching the Void,2000000,15396525,4593598,2004,13396525,669.8262500000001,2000
1113,2004-01-30,The Big Bounce,50000000,6626115,6471394,2004,-43373885,-86.74777,2000
3605,2004-01-30,You Got Served,8000000,50811858,40066497,2004,42811858,535.148225,2000
4971,2004-01-30,Latter Days,850000,865708,833118,2004,15708,1.848,2000
5059,2004-01-30,Osama,500000,1971479,1127331,2004,1471479,294.2958,2000
303,2004-02-04,Home on the Range,110000000,76482461,50026353,2004,-33517539,-30.47049,2000
815,2004-02-04,Hellboy,60000000,99823958,59623958,2004,39823958,66.37326333333333,2000
904,2004-02-04,Walking Tall,56000000,47313824,46213824,2004,-8686176,-15.51102857142857,2000
1797,2004-02-04,The Prince & Me,30000000,29356757,28165882,2004,-643243,-2.144143333333333,2000
3447,2004-02-04,Shaolin Soccer,10000000,42776032,488872,2004,32776032,327.76032000000004,2000
4565,2004-02-07,Before Sunset,2000000,11234552,5792822,2004,9234552,461.72760000000005,2000
584,2004-02-13,50 First Dates,75000000,196320329,120776832,2004,121320329,161.7604386666667,2000
1442,2004-02-20,Against the Ropes,39000000,6429865,5881504,2004,-32570135,-83.51316666666668,2000
1992,2004-02-20,Welcome to Mooseport,26000000,14469428,14469428,2004,-11530572,-44.34835384615385,2000
2096,2004-02-20,Eurotrip,25000000,20718223,17718223,2004,-4281777,-17.127108,2000
2844,2004-02-20,Confessions of a Teenage Drama Queen,15000000,33118854,29331068,2004,18118854,120.79236,2000
3298,2004-02-20,The Blue Butterfly,10400000,1610194,1610194,2004,-8789806,-84.51736538461539,2000
2006,2004-02-25,The Passion of the Christ,25000000,622341924,370782930,2004,597341924,2389.3676960000003,2000
1089,2004-02-27,Twisted,50000000,40119848,25195050,2004,-9880152,-19.760304,2000
3580,2004-02-27,Club Dread,8500000,7573551,5001655,2004,-926449,-10.8994,2000
3821,2004-02-27,"Good Bye, Lenin!",6400000,79384539,4063859,2004,72984539,1140.3834218749998,2000
4066,2004-02-27,Decoys,5000000,96760,84733,2004,-4903240,-98.06479999999999,2000
1827,2004-03-09,Wicker Park,30000000,21577076,13001257,2004,-8422924,-28.076413333333335,2000
2423,2004-03-09,Paparazzi,20000000,16612072,15712072,2004,-3387928,-16.93964,2000
2758,2004-03-09,The Cookout,16000000,11540112,11540112,2004,-4459888,-27.8743,2000
3114,2004-03-09,Tae Guik Gi: The Brotherhood of War,12500000,69826708,1110186,2004,57326708,458.613664,2000
3797,2004-03-09,"Remember Me, My Love",6700000,223878,223878,2004,-6476122,-96.65853731343283,2000
1560,2004-03-12,Closer,35000000,116177695,33987757,2004,81177695,231.93627142857144,2000
3181,2004-03-12,House of Flying Daggers,12000000,92863945,11050094,2004,80863945,673.8662083333334,2000
1895,2004-03-19,Dawn of the Dead,28000000,103452875,58990765,2004,75452875,269.47455357142854,2000
2365,2004-03-19,Eternal Sunshine of the Spotless Mind,20000000,72703462,34366518,2004,52703462,263.51731,2000
2488,2004-03-19,Bon Voyage,20000000,8361736,2353728,2004,-11638264,-58.191320000000005,2000
1551,2004-03-26,The Ladykillers,35000000,77392139,39692139,2004,42392139,121.12039714285714,2000
1577,2004-03-26,Jersey Girl,35000000,37066129,25266129,2004,2066129,5.903225714285714,2000
2017,2004-03-26,Scooby-Doo 2: Monsters Unleashed,25000000,181185387,84185387,2004,156185387,624.741548,2000
2513,2004-03-31,The Touch,20000000,5918742,0,2004,-14081258,-70.40629,2000
212,2004-04-06,Harry Potter and the Prisoner of Azkaban,130000000,796688549,249538952,2004,666688549,512.8373453846154,2000
932,2004-04-16,Kill Bill: Volume 2,55000000,153535982,66207920,2004,98535982,179.1563309090909,2000
1649,2004-04-16,The Punisher,33000000,54533774,33664370,2004,21533774,65.25386060606061,2000
2463,2004-04-16,Connie & Carla,20000000,8047525,8047525,2004,-11952475,-59.762375,2000
800,2004-04-23,Man on Fire,60000000,130968579,77906816,2004,70968579,118.28096500000001,2000
1749,2004-04-23,13 Going On 30,30000000,96439723,57139723,2004,66439723,221.46574333333336,2000
3584,2004-04-23,Silmido,8500000,30298347,298347,2004,21798347,256.45114117647057,2000
4307,2004-04-23,L'incomparable mademoiselle C.,3400000,493905,493905,2004,-2906095,-85.47338235294117,2000
1681,2004-04-30,Laws of Attraction,32000000,29948322,17848322,2004,-2051678,-6.41149375,2000
1825,2004-04-30,Godsend,30000000,16910708,14334645,2004,-13089292,-43.63097333333334,2000
2435,2004-04-30,Envy,20000000,14566246,13548322,2004,-5433754,-27.16877,2000
2569,2004-04-30,Mean Girls,18000000,130953026,86047227,2004,112953026,627.5168111111111,2000
2704,2004-04-30,Bobby Jones: Stroke of Genius,17000000,2694071,2694071,2004,-14305929,-84.15252352941177,2000
563,2004-05-03,Hidalgo,78000000,108086731,67286731,2004,30086731,38.57273205128205,2000
795,2004-05-03,Starsky & Hutch,60000000,170200225,88200225,2004,110200225,183.66704166666668,2000
390,2004-05-11,The Incredibles,92000000,614726752,261441092,2004,522726752,568.1812521739131,2000
1406,2004-05-11,Alfie,40000000,35195939,13395939,2004,-4804061,-12.0101525,2000
157,2004-05-14,Troy,150000000,484161265,133298577,2004,334161265,222.77417666666665,2000
3530,2004-05-14,Breakin' All the Rules,9000000,12512317,12232382,2004,3512317,39.02574444444444,2000
635,2004-05-19,Shrek 2,70000000,937008132,441226247,2004,867008132,1238.5830457142856,2000
241,2004-05-28,The Day After Tomorrow,125000000,556319450,186740799,2004,431319450,345.05556,2000
1069,2004-05-28,Raising Helen,50000000,49928680,37485528,2004,-71320,-0.14264,2000
2754,2004-05-28,Soul Plane,16000000,14553807,13922211,2004,-1446193,-9.03870625,2000
4023,2004-05-28,Saved!,5000000,10206551,8886160,2004,5206551,104.13102,2000
5378,2004-05-28,On the Down Low,10000,1987,1987,2004,-8013,-80.13,2000
1892,2004-06-02,Miracle,28000000,64474705,64378093,2004,36474705,130.26680357142857,2000
2573,2004-06-02,Barbershop 2: Back in Business,18000000,65842412,65070412,2004,47842412,265.79117777777776,2000
2609,2004-06-02,Catch That Kid,18000000,16959614,16703799,2004,-1040386,-5.779922222222222,2000
2929,2004-06-02,The Return,15000000,5953886,501752,2004,-9046114,-60.307426666666665,2000
4182,2004-06-02,What the #$'! Do We Know,4000000,10941801,10941801,2004,6941801,173.545025,2000
5302,2004-06-02,The Lost Skeleton of Cadavra,100000,110536,110536,2004,10536,10.536,2000
789,2004-06-08,Collateral,60000000,217670152,100170152,2004,157670152,262.7835866666667,2000
1807,2004-06-08,Little Black Book,30000000,21758371,20422207,2004,-8241629,-27.47209666666667,2000
3694,2004-06-08,Code 46,7500000,1788324,197148,2004,-5711676,-76.15568,2000
4993,2004-06-08,Saints and Soldiers,780000,1310470,1310470,2004,530470,68.00897435897436,2000
5129,2004-06-10,Tarnation,400000,1162014,592014,2004,762014,190.5035,2000
307,2004-06-16,Around the World in 80 Days,110000000,72004159,24004159,2004,-37995841,-34.54167363636363,2000
590,2004-06-18,The Terminal,75000000,218673959,77073959,2004,143673959,191.56527866666667,2000
1715,2004-06-18,Dodgeball: A True Underdog Story,30000000,167791704,114326736,2004,137791704,459.30568000000005,2000
2328,2004-06-23,White Chicks,20000000,111448997,69148997,2004,91448997,457.244985,2000
3830,2004-06-23,Fahrenheit 9/11,6000000,221148959,119114517,2004,215148959,3585.815983333333,2000
631,2004-06-25,Two Brothers,72000000,62176754,19176754,2004,-9823246,-13.643397222222223,2000
1728,2004-06-25,The Notebook,30000000,116025023,81001787,2004,86025023,286.7500766666667,2000
2875,2004-06-25,De-Lovely,15000000,18524496,13337299,2004,3524496,23.49664,2000
43,2004-06-30,Spider-Man 2,200000000,783705001,373524485,2004,583705001,291.85250049999996,2000
3149,2004-07-04,Johnson Family Vacation,12000000,31286759,31203964,2004,19286759,160.72299166666667,2000
104,2004-07-05,Van Helsing,170000000,300150546,120150546,2004,130150546,76.55914470588236,2000
1404,2004-07-05,New York Minute,40000000,21215882,14018364,2004,-18784118,-46.960295,2000
4987,2004-07-05,The Mudge Boy,800000,62544,62544,2004,-737456,-92.182,2000
426,2004-07-07,King Arthur,90000000,203877963,51877963,2004,113877963,126.53106999999999,2000
312,2004-07-16,"I, Robot",105000000,348629585,144801023,2004,243629585,232.0281761904762,2000
2535,2004-07-16,A Cinderella Story,19000000,70164105,51438175,2004,51164105,269.28476315789476,2000
4107,2004-07-16,Camping Sauvage,4600000,3479302,3479302,2004,-1120698,-24.363,2000
4323,2004-07-16,Maria Full of Grace,3200000,14441158,6529624,2004,11241158,351.2861875,2000
356,2004-07-23,Catwoman,100000000,82145379,40202379,2004,-17854621,-17.854621,2000
442,2004-07-23,The Bourne Supremacy,85000000,288587450,176087450,2004,203587450,239.51464705882356,2000
3817,2004-07-23,A Home at the End of the World,6500000,1033810,1029017,2004,-5466190,-84.09523076923077,2000
4472,2004-07-28,Garden State,2500000,36028802,26782316,2004,33528802,1341.15208,2000
525,2004-07-30,The Manchurian Candidate,80000000,96148711,65948711,2004,16148711,20.18588875,2000
632,2004-07-30,The Village,71682975,257641634,114197520,2004,185958659,259.4181658894598,2000
964,2004-07-30,Thunderbirds,55000000,28231444,6768055,2004,-26768556,-48.67010181818181,2000
3523,2004-07-30,Harold & Kumar Go to White Castle,9000000,18225165,18225165,2004,9225165,102.50183333333334,2000
1743,2004-08-10,Friday Night Lights,30000000,61950770,61255921,2004,31950770,106.50256666666667,2000
2889,2004-08-10,Raise Your Voice,15000000,14811980,10411980,2004,-188020,-1.2534666666666667,2000
734,2004-08-12,Blade: Trinity,65000000,132397389,52397389,2004,67397389,103.68829076923076,2000
651,2004-08-13,AVP: Alien Vs. Predator,70000000,172543519,80281096,2004,102543519,146.49074142857143,2000
2405,2004-08-13,Yu-Gi-Oh,20000000,28762690,19762690,2004,8762690,43.813449999999996,2000
565,2004-08-20,Exorcist: The Beginning,78000000,43957541,41814863,2004,-34042459,-43.644178205128206,2000
1748,2004-08-20,Without a Paddle,30000000,65121280,58156435,2004,35121280,117.07093333333334,2000
5063,2004-08-20,Mean Creek,500000,1348750,603951,2004,848750,169.75,2000
1957,2004-08-27,Suspect Zero,27000000,8712564,8712564,2004,-18287436,-67.73124444444446,2000
2073,2004-08-27,Anacondas: The Hunt for the Blood Orchid,25000000,70326393,31526393,2004,45326393,181.30557199999998,2000
2456,2004-08-27,Super Babies: Baby Geniuses 2,20000000,9355369,9109322,2004,-10644631,-53.223155,2000
2677,2004-08-27,Jet Li's Hero,17000000,177535958,53652140,2004,160535958,944.3291647058822,2000
3448,2004-08-27,The Brown Bunny,10000000,630427,366301,2004,-9369573,-93.69573,2000
2216,2004-09-01,Chasing Liberty,23000000,12291975,12189514,2004,-10708025,-46.55663043478261,2000
3169,2004-09-01,My Baby's Daddy,12000000,17322212,17321573,2004,5322212,44.35176666666666,2000
392,2004-09-04,The Alamo,92000000,23911362,22406362,2004,-68088638,-74.00938913043478,2000
1583,2004-09-04,Ella Enchanted,35000000,22913677,22913677,2004,-12086323,-34.53235142857143,2000
1821,2004-09-04,The Whole Ten Yards,30000000,26323969,16323969,2004,-3676031,-12.253436666666667,2000
2108,2004-09-04,The Girl Next Door,25000000,31635150,14589444,2004,6635150,26.540599999999998,2000
3795,2004-09-04,Shade,6800000,9533964,25032,2004,2733964,40.20535294117647,2000
2018,2004-09-07,Anchorman: The Legend of Ron Burgundy,25000000,89476265,84136909,2004,64476265,257.90506,2000
3390,2004-09-07,Sleepover,10000000,9408183,9408183,2004,-591817,-5.91817,2000
4462,2004-09-07,Riding Giants,2600000,3292333,2276368,2004,692333,26.628192307692306,2000
670,2004-09-17,Sky Captain and the World of Tomorrow,70000000,49730854,37760080,2004,-20269146,-28.95592285714286,2000
1595,2004-09-17,Wimbledon,35000000,41666476,16862585,2004,6666476,19.047074285714285,2000
1805,2004-09-17,Mr. 3000,30000000,21827296,21800302,2004,-8172704,-27.242346666666666,2000
4760,2004-09-17,Incident at Loch Ness,1400000,56073,36830,2004,-1343927,-95.99478571428571,2000
1036,2004-09-24,The Forgotten,50000000,117211892,66711892,2004,67211892,134.42378399999998,2000
1429,2004-09-24,The Last Shot,40000000,463730,463730,2004,-39536270,-98.840675,2000
1836,2004-09-24,First Daughter,30000000,10419084,9055010,2004,-19580916,-65.26971999999999,2000
4006,2004-09-24,Shaun of the Dead,5000000,30332385,13542874,2004,25332385,506.6477,2000
4898,2004-09-24,Guiana 1838,1000000,227241,227241,2004,-772759,-77.2759,2000
1048,2004-10-09,Resident Evil: Apocalypse,50000000,125168734,50740078,2004,75168734,150.337468,2000
1201,2004-10-09,Cellular,45000000,61475984,32003620,2004,16475984,36.613297777777774,2000
5243,2004-10-09,Malevolence,200000,346106,126021,2004,146106,73.053,2000
3273,2004-10-10,Vera Drake,11000000,13353855,3753806,2004,2353855,21.39868181818182,2000
101,2004-10-11,The Polar Express,170000000,319090241,194949659,2004,149090241,87.70014176470589,2000
289,2004-10-12,Ocean's Twelve,110000000,362989076,125531634,2004,252989076,229.9900690909091,2000
1090,2004-10-12,The Life Aquatic with Steve Zissou,50000000,34806726,24006726,2004,-15193274,-30.386548,2000
4623,2004-10-12,Freeze Frame,2000000,105377,0,2004,-1894623,-94.73115,2000
5134,2004-10-12,Fabled,400000,31425,31425,2004,-368575,-92.14375,2000
1326,2004-10-15,Shall We Dance?,40000000,118097882,57887882,2004,78097882,195.244705,2000
2370,2004-10-15,Team America: World Police,20000000,50948811,32774834,2004,30948811,154.744055,2000
2621,2004-10-15,Being Julia,18000000,14488705,7739049,2004,-3511295,-19.507194444444444,2000
3466,2004-10-15,Eulogy,10000000,70527,70527,2004,-9929473,-99.29473,2000
2671,2004-10-22,Sideways,17000000,109793192,71502303,2004,92793192,545.842305882353,2000
3304,2004-10-22,The Grudge,10000000,187281115,110359362,2004,177281115,1772.81115,2000
4050,2004-10-22,The Machinist,5000000,8655397,1082044,2004,3655397,73.10794,2000
5237,2004-10-22,Short Cut to Nirvana: Kumbh Mela,200000,439651,381225,2004,239651,119.8255,2000
1309,2004-10-29,Ray,40000000,124823094,75305995,2004,84823094,212.057735,2000
2479,2004-10-29,Birth,20000000,14603001,5005899,2004,-5396999,-26.984995,2000
4792,2004-10-29,Saw,1200000,103880027,55968727,2004,102680027,8556.668916666666,2000
266,2004-11-06,The Chronicles of Riddick,120000000,107212751,57712751,2004,-12787249,-10.656040833333332,2000
349,2004-11-06,The Stepford Wives,100000000,96221971,59475623,2004,-3778029,-3.778029,2000
1031,2004-11-06,Garfield,50000000,208094550,75367693,2004,158094550,316.1891,2000
1167,2004-11-08,The Princess Diaries 2: Royal Engagement,45000000,122071435,95149435,2004,77071435,171.26985555555555,2000
330,2004-11-19,National Treasure,100000000,331323410,173005002,2004,231323410,231.32341,2000
1726,2004-11-19,SpongeBob SquarePants: The Movie,30000000,142051255,85416609,2004,112051255,373.50418333333334,2000
4034,2004-11-19,La mala educación,5000000,40311842,5211842,2004,35311842,706.23684,2000
130,2004-11-24,Alexander,155000000,167297191,34297191,2004,12297191,7.933671612903225,2000
1032,2004-11-24,Christmas with the Kranks,50000000,96469187,73701902,2004,46469187,92.938374,2000
3689,2004-11-24,The Work and the Glory,7500000,3347647,3347647,2004,-4152353,-55.36470666666666,2000
965,2004-11-26,Un long dimanche de fiançailles,55000000,69759296,6167817,2004,14759296,26.83508363636364,2000
3930,2004-11-26,Les Choristes,5500000,83529758,3629758,2004,78029758,1418.7228727272727,2000
1341,2004-12-03,Secret Window,40000000,92111551,47958031,2004,52111551,130.2788775,2000
1989,2004-12-03,Agent Cody Banks 2: Destination London,26000000,28703083,23514247,2004,2703083,10.396473076923076,2000
900,2004-12-11,After the Sunset,57000000,38329114,28328132,2004,-18670886,-32.7559403508772,2000
1064,2004-12-11,Bridget Jones: The Edge Of Reason,50000000,263894551,40203020,2004,213894551,427.789102,2000
1873,2004-12-11,Seed of Chucky,29000000,24716190,17016190,2004,-4283810,-14.771758620689655,2000
2040,2004-12-11,Finding Neverland,25000000,115036108,51676606,2004,90036108,360.144432,2000
3269,2004-12-11,Kinsey,11000000,13000959,10214647,2004,2000959,18.190536363636365,2000
3753,2004-12-11,Veer-Zaara,7000000,7017859,2938532,2004,17859,0.2551285714285714,2000
1721,2004-12-15,Million Dollar Baby,30000000,231928227,100492203,2004,201928227,673.09409,2000
293,2004-12-17,The Aviator,110000000,208370892,102608827,2004,98370892,89.42808363636362,2000
337,2004-12-17,Lemony Snicket's A Series of Unfortunate Events,100000000,212956024,118627117,2004,112956024,112.956024,2000
602,2004-12-17,Spanglish,75000000,54344321,42044321,2004,-20655679,-27.54090533333333,2000
611,2004-12-17,Flight of the Phoenix,75000000,34009180,21009180,2004,-40990820,-54.654426666666666,2000
2190,2004-12-17,Beyond the Sea,24000000,8292914,6144806,2004,-15707086,-65.44619166666666,2000
3029,2004-12-17,Mar adentro,13300000,39686345,2086345,2004,26386345,198.39357142857145,2000
3452,2004-12-17,Imaginary Heroes,10000000,290875,228524,2004,-9709125,-97.09125,2000
773,2004-12-22,Meet the Fockers,60000000,516567575,279167575,2004,456567575,760.9459583333332,2000
940,2004-12-22,The Phantom of the Opera,55000000,154017885,51225796,2004,99017885,180.03251818181818,2000
2661,2004-12-22,Hotel Rwanda,17500000,36521223,23519128,2004,19021223,108.69270285714285,2000
1193,2004-12-25,Fat Albert,45000000,48563556,48114556,2004,3563556,7.919013333333333,2000
3292,2004-12-25,Darkness,10600000,34409206,22163442,2004,23809206,224.61515094339623,2000
1844,2004-12-29,The Merchant of Venice,30000000,18765585,3765585,2004,-11234415,-37.44805,2000
1982,2004-12-29,In Good Company,26000000,63489752,45489752,2004,37489752,144.19135384615385,2000
1310,2005-01-04,Sin City,40000000,158527918,74103820,2005,118527918,296.319795,2000
2057,2005-01-06,The Sisterhood of the Traveling Pants,25000000,41560117,39053061,2005,16560117,66.24046799999999,2000
1215,2005-01-07,Rebound,45000000,17492014,16809014,2005,-27507986,-61.12885777777778,2000
3933,2005-01-07,De battre mon coeur s'est arrêté,5500000,8589831,1023424,2005,3089831,56.17874545454546,2000
5002,2005-01-07,Undead,750000,229250,41196,2005,-520750,-69.43333333333334,2000
746,2005-01-14,Elektra,65000000,56409722,24409722,2005,-8590278,-13.215812307692307,2000
1178,2005-01-14,Coach Carter,45000000,76665507,67264877,2005,31665507,70.36779333333332,2000
1763,2005-01-14,Racing Stripes,30000000,89955540,49772522,2005,59955540,199.8518,2000
1809,2005-01-19,Assault On Precinct 13,30000000,36040895,20040895,2005,6040895,20.13631666666667,2000
2321,2005-01-21,Are We There Yet?,20000000,98114471,82674398,2005,78114471,390.57235499999996,2000
5122,2005-01-21,Gory Gory Hallelujah,425000,12604,12604,2005,-412396,-97.03435294117646,2000
2042,2005-01-28,Hide and Seek,25000000,123696741,51100486,2005,98696741,394.786964,2000
2478,2005-01-28,Alone in the Dark,20000000,8178569,5178569,2005,-11821431,-59.107155,2000
4070,2005-01-28,Fascination,5000000,83356,16670,2005,-4916644,-98.33288,2000
5318,2005-01-28,"Peace, Propaganda and the Promised Land",70000,4930,4930,2005,-65070,-92.95714285714286,2000
555,2005-02-09,A Sound of Thunder,80000000,6300451,1900451,2005,-73699549,-92.12443625,2000
1672,2005-02-09,The Transporter 2,32000000,88978458,43095856,2005,56978458,178.05768125,2000
2134,2005-02-09,Underclassman,25000000,5654777,5654777,2005,-19345223,-77.380892,2000
955,2005-02-12,Aeon Flux,55000000,53913573,25857987,2005,-1086427,-1.9753218181818182,2000
363,2005-02-18,Son of the Mask,100000000,59918422,17018422,2005,-40081578,-40.081578,2000
591,2005-02-18,Constantine,75000000,221594911,75976178,2005,146594911,195.45988133333333,2000
2837,2005-02-18,Because of Winn-Dixie,15000000,33508485,32647042,2005,18508485,123.38990000000001,2000
3025,2005-02-18,Der Untergang,13500000,93631744,5501940,2005,80131744,593.5684740740741,2000
1097,2005-02-25,Man of the House,50000000,22099706,19699706,2005,-27900294,-55.800588,2000
1590,2005-02-25,Cursed,35000000,25114901,19294901,2005,-9885099,-28.24314,2000
3923,2005-02-25,Diary of a Mad Black Woman,5500000,50458356,50406346,2005,44958356,817.4246545454546,2000
435,2005-03-06,Cinderella Man,88000000,105021488,61649911,2005,17021488,19.342599999999997,2000
2120,2005-03-06,The Lords of Dogtown,25000000,13424365,11273517,2005,-11575635,-46.30254,2000
4868,2005-03-08,Junebug,1000000,3553253,2678010,2005,2553253,255.32530000000003,2000
1028,2005-03-18,The Ring Two,50000000,161941727,75941727,2005,111941727,223.883454,2000
2084,2005-03-18,Ice Princess,25000000,25732334,24381334,2005,732334,2.929336,2000
2501,2005-03-18,Steamboy,20000000,10468867,468867,2005,-9531133,-47.655665,2000
4920,2005-03-18,The Helix…Loaded,1000000,3700,3700,2005,-996300,-99.63,2000
829,2005-03-24,Miss Congeniality 2: Armed and Fabulous,60000000,101382396,48478006,2005,41382396,68.97066,2000
1527,2005-03-25,Guess Who,35000000,102115888,68915888,2005,67115888,191.75968,2000
4290,2005-03-25,D.E.B.S.,3500000,96793,96793,2005,-3403207,-97.23448571428571,2000
4394,2005-03-25,Oldboy,3000000,6239723,707391,2005,3239723,107.99076666666667,2000
4727,2005-03-25,The Ballad of Jack and Rose,1500000,1126258,712294,2005,-373742,-24.916133333333335,2000
2062,2005-03-30,Beauty Shop,25000000,38351350,36351350,2005,13351350,53.4054,2000
2345,2005-04-02,Boogeyman,20000000,67192859,46752382,2005,47192859,235.964295,2000
2838,2005-04-02,The Wedding Date,15000000,47175038,31726995,2005,32175038,214.50025333333335,2000
596,2005-04-03,Be Cool,75000000,94944017,55849401,2005,19944017,26.592022666666665,2000
903,2005-04-03,The Pacifier,56000000,198006880,113006880,2005,142006880,253.58371428571428,2000
1880,2005-04-03,The Jacket,28500000,15452978,6301131,2005,-13047022,-45.77902456140351,2000
4109,2005-04-03,Dear Frankie,4600000,3099369,1340891,2005,-1500631,-32.62241304347826,2000
628,2005-04-11,Jarhead,72000000,96947540,62647540,2005,24947540,34.64936111111111,2000
779,2005-04-11,Chicken Little,60000000,310043823,135386665,2005,250043823,416.739705,2000
4704,2005-04-11,I Love Your Work,1600000,3264,3264,2005,-1596736,-99.79599999999999,2000
4747,2005-04-11,Wal-Mart: The High Cost of Low Price,1500000,58692,0,2005,-1441308,-96.0872,2000
2558,2005-04-15,The Amityville Horror,18500000,109175673,65233369,2005,90675673,490.13877297297296,2000
4593,2005-04-15,House of D,2000000,466106,388532,2005,-1533894,-76.69470000000001,2000
4600,2005-04-15,It's All Gone Pete Tong,2000000,2226603,120620,2005,226603,11.33015,2000
418,2005-04-22,The Interpreter,90000000,162753837,72708161,2005,72753837,80.83759666666667,2000
2089,2005-04-22,A Lot Like Love,25000000,41921590,21835784,2005,16921590,67.68636000000001,2000
2139,2005-04-22,King's Ransom,25000000,4049527,4008527,2005,-20950473,-83.801892,2000
2502,2005-04-22,The Game of Their Lives,20000000,375474,375474,2005,-19624526,-98.12263,2000
2783,2005-04-22,Madison,15500000,517262,517262,2005,-14982738,-96.66282580645161,2000
858,2005-04-29,XXX: State of the Union,60000000,71073932,26873932,2005,11073932,18.456553333333332,2000
1191,2005-04-29,The Hitchhiker's Guide to the Galaxy,45000000,102746214,51019112,2005,57746214,128.32492,2000
4758,2005-04-29,Holy Girl,1400000,1261792,304124,2005,-138208,-9.872,2000
5350,2005-04-29,Funny Ha Ha,30000,82698,77070,2005,52698,175.66,2000
977,2005-05-08,The Dukes of Hazzard,53000000,109848461,80270227,2005,56848461,107.26124716981131,2000
3206,2005-05-08,2046,12000000,19287485,1442338,2005,7287485,60.729041666666674,2000
3794,2005-05-08,The Chumscrubber,6800000,49526,49526,2005,-6750474,-99.27167647058823,2000
3950,2005-05-08,Saint Ralph,5200000,1695126,795126,2005,-3504874,-67.40142307692307,2000
1751,2005-05-10,Wallace & Gromit: The Curse of the Were-Rabbit,30000000,197593152,56068547,2005,167593152,558.64384,2000
4714,2005-05-10,The Squid and the Whale,1500000,11191423,7372734,2005,9691423,646.0948666666667,2000
1172,2005-05-13,Monster-in-Law,45000000,155931301,82931301,2005,110931301,246.51400222222222,2000
1190,2005-05-13,Kicking and Screaming,45000000,55842724,52842724,2005,10842724,24.094942222222222,2000
1242,2005-05-13,Danny the Dog,43000000,49037621,24537621,2005,6037621,14.040979069767442,2000
1961,2005-05-13,Mindhunters,27000000,16566235,4476235,2005,-10433765,-38.643574074074074,2000
3813,2005-05-13,Layer Cake,6500000,11745931,2339957,2005,5245931,80.70663076923077,2000
5052,2005-05-13,Mad Hot Ballroom,500000,9387581,8117961,2005,8887581,1777.5162000000003,2000
273,2005-05-19,Star Wars Ep. III: Revenge of the Sith,115000000,848998877,380270577,2005,733998877,638.2598930434782,2000
482,2005-05-27,The Longest Yard,82000000,190320568,158119460,2005,108320568,132.09825365853658,2000
578,2005-05-27,Madagascar,75000000,556559566,193595521,2005,481559566,642.0794213333334,2000
4486,2005-05-27,Saving Face,2500000,1269705,1187266,2005,-1230295,-49.2118,2000
305,2005-06-05,Kingdom of Heaven,110000000,218853353,47398413,2005,108853353,98.95759363636364,2000
1565,2005-06-05,House of Wax,35000000,70064800,32064800,2005,35064800,100.18514285714286,2000
3701,2005-06-05,Crash,7303082,101173038,55334418,2005,93869956,1285.3471452189638,2000
5172,2005-06-05,Fighting Tommy Riley,300000,10514,10514,2005,-289486,-96.49533333333333,2000
146,2005-06-15,Batman Begins,150000000,359142722,205343774,2005,209142722,139.42848133333334,2000
3369,2005-06-17,The Perfect Man,10000000,19535005,16535005,2005,9535005,95.35005,2000
4571,2005-06-17,Me and You and Everyone We Know,2000000,9615464,3885134,2005,7615464,380.77320000000003,2000
4690,2005-06-17,My Summer of Love,1700000,4727375,1000915,2005,3027375,178.08088235294116,2000
1037,2005-06-22,Herbie: Fully Loaded,50000000,144110682,66010682,2005,94110682,188.221364,2000
527,2005-06-24,Bewitched,80000000,131159306,63313159,2005,51159306,63.949132500000005,2000
2556,2005-06-24,George A. Romero's Land of the Dead,18975000,47751015,20700082,2005,28776015,151.65225296442688,2000
4303,2005-06-24,La marche de l'empereur,3400000,133276359,77437223,2005,129876359,3819.8929117647062,2000
4691,2005-06-24,Yes,1700000,661221,396035,2005,-1038779,-61.104647058823524,2000
5011,2005-06-24,Rize,700000,4857731,3278611,2005,4157731,593.9615714285713,2000
209,2005-06-29,War of the Worlds,132000000,606836535,234280354,2005,474836535,359.7246477272727,2000
3313,2005-07-01,White Noise,10000000,92094360,56094360,2005,82094360,820.9436000000001,2000
4672,2005-07-01,Travellers and Magicians,1800000,1322161,506793,2005,-477839,-26.546611111111112,2000
5247,2005-07-01,Solitude,200000,6260,6260,2005,-193740,-96.87,2000
2396,2005-07-10,2 For the Money,20000000,30491379,22991379,2005,10491379,52.456895,2000
3718,2005-07-10,"Good Night, and Good Luck",7000000,56586901,31501218,2005,49586901,708.3842999999999,2000
4823,2005-07-10,Waiting...,1125000,18673274,16124543,2005,17548274,1559.8465777777778,2000
2136,2005-07-12,The World's Fastest Indian,25000000,18991288,5128124,2005,-6008712,-24.034848,2000
5388,2005-07-13,Return to the Land of Wonders,5000,1338,1338,2005,-3662,-73.24000000000001,2000
143,2005-07-15,Charlie and the Chocolate Factory,150000000,475825484,206459076,2005,325825484,217.21698933333334,2000
1277,2005-07-15,The Wedding Crashers,40000000,283218368,209218368,2005,243218368,608.04592,2000
5164,2005-07-15,First Morning,300000,87264,87264,2005,-212736,-70.91199999999999,2000
5201,2005-07-15,On the Outs,250000,237816,49772,2005,-12184,-4.8736,2000
269,2005-07-22,The Island,120000000,163018913,35818913,2005,43018913,35.84909416666667,2000
1563,2005-07-22,The Bad News Bears,35000000,33500620,32868349,2005,-1499380,-4.283942857142857,2000
3730,2005-07-22,The Devil's Rejects,7000000,20940428,17044981,2005,13940428,199.14897142857143,2000
4444,2005-07-22,Hustle & Flow,2800000,23591783,22202809,2005,20791783,742.5636785714286,2000
5196,2005-07-22,November,250000,191862,191862,2005,-58138,-23.255200000000002,2000
195,2005-07-29,Stealth,138000000,76416746,32116746,2005,-61583254,-44.62554637681159,2000
1530,2005-07-29,Sky High,35000000,83109359,63939454,2005,48109359,137.45531142857143,2000
1546,2005-07-29,Must Love Dogs,35000000,58405313,43894863,2005,23405313,66.87232285714285,2000
178,2005-08-04,Sahara,145000000,121671925,68671925,2005,-23328075,-16.088327586206898,2000
1350,2005-08-04,Fever Pitch,40000000,50071069,42071069,2005,10071069,25.177672499999996,2000
2418,2005-08-04,Kung Fu Hustle,20000000,102034104,17104669,2005,82034104,410.17051999999995,2000
436,2005-08-07,Fantastic Four,87500000,330717080,154696080,2005,243217080,277.9623771428572,2000
861,2005-08-07,Dark Water,60000000,49473093,25473093,2005,-10526907,-17.544845000000002,2000
5146,2005-08-07,Murderball,350000,1772979,1531154,2005,1422979,406.5654285714285,2000
1846,2005-08-17,Supercross,30000000,3252550,3102550,2005,-26747450,-89.15816666666667,2000
1588,2005-08-19,Valiant,35000000,64188387,19478106,2005,29188387,83.39539142857143,2000
1968,2005-08-19,The 40 Year-old Virgin,26000000,177344230,109449237,2005,151344230,582.0931923076923,2000
1976,2005-08-19,Red Eye,26000000,96666486,57891803,2005,70666486,271.7941769230769,2000
536,2005-08-26,The Brothers Grimm,80000000,105299638,37899638,2005,25299638,31.6245475,2000
1824,2005-08-26,The Cave,30000000,27147991,15007991,2005,-2852009,-9.506696666666667,2000
3544,2005-08-26,Undiscovered,9000000,1069318,1069318,2005,-7930682,-88.11868888888888,2000
2004,2005-08-31,The Constant Gardener,25500000,86301599,33579798,2005,60801599,238.4376431372549,2000
1837,2005-09-09,An Unfinished Life,30000000,18535575,8535575,2005,-11464425,-38.214749999999995,2000
2460,2005-09-09,The Man,20000000,10393696,8330720,2005,-9606304,-48.03152,2000
2571,2005-09-09,The Exorcism of Emily Rose,18000000,144529078,75072454,2005,126529078,702.9393222222222,2000
5244,2005-09-09,Side Effects,200000,44701,44701,2005,-155299,-77.6495,2000
1371,2005-09-11,Get Rich or Die Tryin',40000000,46666955,30981850,2005,6666955,16.6673875,2000
72,2005-09-12,"The Chronicles of Narnia: The Lion, the Witch and the Wardrobe",180000000,720539572,291710957,2005,540539572,300.2997622222222,2000
460,2005-09-12,Memoirs of a Geisha,85000000,161510853,57010853,2005,76510853,90.01276823529412,2000
2448,2005-09-12,Mrs. Henderson Presents,20000000,27836366,11036366,2005,7836366,39.18183,2000
3016,2005-09-12,Brokeback Mountain,13900000,177012173,83043761,2005,163112173,1173.4688705035971,2000
4776,2005-09-12,Neal n' Nikki,1300000,329621,100358,2005,-970379,-74.64453846153846,2000
887,2005-09-16,Just Like Heaven,58000000,100687083,48318130,2005,42687083,73.59841896551724,2000
1263,2005-09-16,Lord of War,42000000,60437727,24149632,2005,18437727,43.89935,2000
2147,2005-09-16,Venom,25000000,881745,881745,2005,-24118255,-96.47301999999999,2000
2467,2005-09-16,Proof,20000000,8284331,7535331,2005,-11715669,-58.578345,2000
4206,2005-09-16,Thumbsucker,4000000,1919197,1328679,2005,-2080803,-52.020075,2000
4851,2005-09-16,Cry Wolf,1000000,15943081,10047674,2005,14943081,1494.3081,2000
4907,2005-09-16,Chocolate: Deep Dark Secrets,1000000,1549000,49000,2005,549000,54.900000000000006,2000
753,2005-09-23,Oliver Twist,65000000,26670920,2070920,2005,-38329080,-58.967815384615385,2000
923,2005-09-23,Flightplan,55000000,214392904,89706988,2005,159392904,289.80528,2000
1678,2005-09-23,A History of Violence,32000000,61477797,31493782,2005,29477797,92.118115625,2000
1753,2005-09-23,The Corpse Bride,30000000,114770654,53359111,2005,84770654,282.5688466666667,2000
3366,2005-09-23,Roll Bounce,10000000,17433072,17380866,2005,7433072,74.33072,2000
3663,2005-09-23,Dear Wendy,8000000,446438,23106,2005,-7553562,-94.41952500000001,2000
4701,2005-09-23,Dil Jo Bhi Kahey...,1600000,129319,129319,2005,-1470681,-91.9175625,2000
4742,2005-09-28,Forty Shades of Blue,1500000,172569,75828,2005,-1327431,-88.4954,2000
1100,2005-09-30,Into the Blue,50000000,41982227,18782227,2005,-8017773,-16.035546,2000
1441,2005-09-30,Serenity,39000000,40319440,25514517,2005,1319440,3.383179487179487,2000
2104,2005-09-30,The Greatest Game Ever Played,25000000,15468266,15331289,2005,-9531734,-38.126936,2000
3208,2005-09-30,Duma,12000000,994790,870067,2005,-11005210,-91.71008333333333,2000
3719,2005-09-30,Capote,7000000,49924079,28750530,2005,42924079,613.2011285714285,2000
4208,2005-09-30,MirrorMask,4000000,973613,864959,2005,-3026387,-75.65967500000001,2000
4414,2005-09-30,My Big Fat Independent Movie,3000000,4655,4655,2005,-2995345,-99.84483333333334,2000
284,2005-10-06,Mr. and Mrs. Smith,110000000,486124090,186336279,2005,376124090,341.9309909090909,2000
1066,2005-10-06,The Adventures of Sharkboy and Lavagirl in 3-D,50000000,69425966,39177684,2005,19425966,38.851932,2000
1954,2005-10-06,The Honeymooners,27000000,13174426,12834849,2005,-13825574,-51.205829629629626,2000
2191,2005-10-06,Hauru no ugoku shiro,24000000,237814327,4710455,2005,213814327,890.8930291666668,2000
2194,2005-10-06,The Bridge of San Luis Rey,24000000,1696765,49981,2005,-22303235,-92.93014583333333,2000
4441,2005-10-06,High Tension,2850000,6435262,3681066,2005,3585262,125.79866666666666,2000
5135,2005-10-13,The Dark Hours,400000,423,423,2005,-399577,-99.89425,2000
974,2005-10-14,Elizabethtown,54000000,50719373,26850426,2005,-3280627,-6.075235185185185,2000
1108,2005-10-14,Domino,50000000,22969202,10169202,2005,-27030798,-54.061596,2000
2148,2005-10-14,Where the Truth Lies,25000000,1415656,872142,2005,-23584344,-94.33737599999999,2000
2592,2005-10-14,The Fog,18000000,37048526,29511112,2005,19048526,105.82514444444445,2000
673,2005-10-21,Doom,70000000,54612337,28212337,2005,-15387663,-21.982375714285716,2000
1677,2005-10-21,Dreamer: Inspired by a True Story,32000000,39498360,33022286,2005,7498360,23.432375,2000
1814,2005-10-21,North Country,30000000,23676771,18324242,2005,-6323229,-21.07743,2000
2912,2005-10-21,"Kiss Kiss, Bang Bang",15000000,16829464,4235837,2005,1829464,12.196426666666667,2000
3685,2005-10-21,Shopgirl,7500000,11758418,10284523,2005,4258418,56.778906666666664,2000
3815,2005-10-21,The Work and the Glory: American Zion,6500000,2025032,2025032,2005,-4474968,-68.84566153846153,2000
5082,2005-10-21,The Californians,500000,4134,4134,2005,-495866,-99.1732,2000
532,2005-10-28,The Legend of Zorro,80000000,141475336,45575336,2005,61475336,76.84417,2000
2442,2005-10-28,The Weather Man,20000000,15466961,12482775,2005,-4533039,-22.665195,2000
3957,2005-10-28,Saw II,5000000,152925093,87025093,2005,147925093,2958.5018600000003,2000
908,2005-11-02,Hitch,55000000,366784257,177784257,2005,311784257,566.8804672727273,2000
2413,2005-11-02,Pooh's Heffalump Movie,20000000,55686944,18098433,2005,35686944,178.43472,2000
3746,2005-11-02,Bride & Prejudice,7000000,25269040,6601079,2005,18269040,260.9862857142857,2000
4588,2005-11-02,Inside Deep Throat,2000000,691880,691880,2005,-1308120,-65.40599999999999,2000
499,2005-11-03,Robots,80000000,260700012,128200012,2005,180700012,225.875015,2000
607,2005-11-03,Hostage,75000000,77636443,34636443,2005,2636443,3.5152573333333335,2000
3166,2005-11-03,The Upside of Anger,12000000,28915761,18761993,2005,16915761,140.964675,2000
744,2005-11-11,Zathura,65000000,58545540,28045540,2005,-6454460,-9.92993846153846,2000
1905,2005-11-11,Pride & Prejudice,28000000,126549607,38372662,2005,98549607,351.96288214285715,2000
2245,2005-11-11,Derailed,22000000,57520063,36020063,2005,35520063,161.45483181818182,2000
138,2005-11-18,Harry Potter and the Goblet of Fire,150000000,896911078,290013036,2005,746911078,497.9407186666666,2000
1865,2005-11-18,Walk the Line,29000000,187707495,119519402,2005,158707495,547.2672241379311,2000
1047,2005-11-23,Syriana,50000000,92690959,50824620,2005,42690959,85.381918,2000
1189,2005-11-23,"Yours, Mine and Ours",45000000,72359917,53359917,2005,27359917,60.79981555555556,2000
1375,2005-11-23,Rent,40000000,31670620,29077547,2005,-8329380,-20.823449999999998,2000
2271,2005-11-23,The Libertine,22000000,9448623,4835065,2005,-12551377,-57.05171363636363,2000
873,2005-12-08,The Great Raid,60000000,10597070,10166502,2005,-49402930,-82.33821666666667,2000
1342,2005-12-08,The Skeleton Key,40000000,92256918,47907715,2005,52256918,130.642295,2000
1733,2005-12-08,Four Brothers,30000000,92494381,74494381,2005,62494381,208.3146033333333,2000
2252,2005-12-08,Deuce Bigalow: European Gigolo,22000000,45273464,22400154,2005,23273464,105.78847272727272,2000
35,2005-12-14,King Kong,207000000,550517357,218080025,2005,343517357,165.95041400966184,2000
2909,2005-12-14,Los tres entierros de Melquiades Estrada,15000000,13454474,5027684,2005,-1545526,-10.303506666666665,2000
1213,2005-12-16,The Producers: The Movie Musical,45000000,32952995,19398532,2005,-12047005,-26.77112222222222,2000
2574,2005-12-16,The Family Stone,18000000,92357499,60062868,2005,74357499,413.0972166666667,2000
189,2005-12-21,Fun With Dick And Jane,140000000,203018919,110550000,2005,63018919,45.01351357142857,2000
797,2005-12-21,Cheaper by the Dozen 2,60000000,135015330,82571173,2005,75015330,125.02555,2000
2770,2005-12-21,The White Countess,16000000,2814566,1669971,2005,-13185434,-82.4089625,2000
597,2005-12-23,Munich,75000000,131492772,47379090,2005,56492772,75.323696,2000
3639,2005-12-23,Caché,8000000,19891331,3647381,2005,11891331,148.6416375,2000
665,2005-12-25,Rumor Has It,70000000,88933562,42996140,2005,18933562,27.047945714285714,2000
1828,2005-12-25,The New World,30000000,26184400,12712093,2005,-3815600,-12.718666666666667,2000
4825,2005-12-25,Wolf Creek,1100000,29005064,16186348,2005,27905064,2536.824,2000
2854,2005-12-28,Match Point,15000000,87973835,23089926,2005,72973835,486.49223333333333,2000
3380,2005-12-30,The Matador,10000000,17300838,12589255,2005,7300838,73.00837999999999,2000
2944,2005-12-31,Dungeons & Dragons: Wrath of the Dragon God,15000000,909822,0,2005,-14090178,-93.93451999999999,2000
4531,2005-12-31,Chicken Tikka Masala,2160000,37865,0,2005,-2122135,-98.24699074074074,2000
3152,2006-01-09,Crank,12000000,43924923,27838408,2006,31924923,266.041025,2000
3916,2006-01-09,Crossover,5600000,7009668,7009668,2006,1409668,25.172642857142858,2000
4451,2006-01-09,Lage Raho Munna Bhai,2700000,31517561,2217561,2006,28817561,1067.317074074074,2000
4511,2006-01-09,Idiocracy,2400000,500296,444093,2006,-1899704,-79.15433333333334,2000
5349,2006-01-09,Mutual Appreciation,30000,103509,103509,2006,73509,245.03,2000
1553,2006-01-12,The Nativity Story,35000000,46309644,37629831,2006,11309644,32.31326857142857,2000
3400,2006-01-12,Turistas,10000000,14321070,7027762,2006,4321070,43.2107,2000
1198,2006-01-13,Last Holiday,45000000,43343247,38399961,2006,-1656753,-3.681673333333333,2000
1769,2006-01-13,Glory Road,30000000,42799060,42647449,2006,12799060,42.66353333333333,2000
2659,2006-01-13,Hoodwinked,17500000,109843390,51386611,2006,92343390,527.6765142857143,2000
1182,2006-01-20,Underworld: Evolution,45000000,113417762,62318875,2006,68417762,152.0394711111111,2000
3383,2006-01-20,End of the Spear,10000000,11924041,11748661,2006,1924041,19.24041,2000
4854,2006-01-20,Transamerica,1000000,16553163,9015303,2006,15553163,1555.3163,2000
1316,2006-01-27,Big Momma's House 2,40000000,137047376,70165972,2006,97047376,242.61844,2000
2045,2006-01-27,Nanny McPhee,25000000,128745578,47279279,2006,103745578,414.982312,2000
2957,2006-01-27,Manderlay,14200000,543306,74205,2006,-13656694,-96.1739014084507,2000
3673,2006-01-27,Imagine Me & You,7900000,3129471,672243,2006,-4770529,-60.38644303797468,2000
3943,2006-01-27,Rang De Basanti,5300000,29197694,2197694,2006,23897694,450.8998867924528,2000
4100,2006-01-27,Tristram Shandy: A Cock and Bull Story,4750000,3061763,1253413,2006,-1688237,-35.54183157894737,2000
4700,2006-01-27,Bubble,1600000,145382,145382,2006,-1454618,-90.913625,2000
989,2006-02-06,The Break-Up,52000000,205727307,118703275,2006,153727307,295.6294365384615,2000
2923,2006-02-06,Banlieue 13,15000000,11599903,1200216,2006,-3400097,-22.667313333333333,2000
3424,2006-02-06,Peaceful Warrior,10000000,3260179,2893666,2006,-6739821,-67.39821,2000
5369,2006-02-06,The Puffy Chair,15000,195254,194523,2006,180254,1201.6933333333334,2000
5126,2006-02-08,Quinceanera,400000,2797199,1692693,2006,2397199,599.29975,2000
1305,2006-02-17,Eight Below,40000000,120455994,81612565,2006,80455994,201.13998500000002,2000
2341,2006-02-17,Date Movie,20000000,85146165,48548426,2006,65146165,325.730825,2000
4155,2006-02-17,Nochnoy dozor,4200000,33913542,1502188,2006,29713542,707.4652857142858,2000
4289,2006-02-17,Winter Passing,3500000,113783,107492,2006,-3386217,-96.74905714285714,2000
2466,2006-02-24,Doogal,20000000,28058652,7578946,2006,8058652,40.29326,2000
2702,2006-02-24,Running Scared,17000000,9729088,6855137,2006,-7270912,-42.77007058823529,2000
3312,2006-02-24,Madea's Family Reunion,10000000,63320521,63257940,2006,53320521,533.2052100000001,2000
4387,2006-02-24,Tsotsi,3000000,11537539,2912606,2006,8537539,284.58463333333333,2000
2815,2006-03-02,When a Stranger Calls,15000000,67215435,47860214,2006,52215435,348.1029,2000
1199,2006-03-03,16 Blocks,45000000,65595141,36895141,2006,20595141,45.766980000000004,2000
1813,2006-03-03,Ultraviolet,30000000,30962112,18522064,2006,962112,3.20704,2000
2275,2006-03-03,Joyeux Noël,22000000,23134075,1054361,2006,1134075,5.154886363636364,2000
3167,2006-03-03,Aquamarine,12000000,22978953,18597342,2006,10978953,91.491275,2000
4355,2006-03-03,Dave Chappelle's Block Party,3000000,12051924,11718595,2006,9051924,301.7308,2000
171,2006-03-11,Flushed Away,149000000,179357126,64665672,2006,30357126,20.373910067114092,2000
2565,2006-03-11,Borat,18000000,261443242,128505958,2006,243443242,1352.4624555555556,2000
3502,2006-03-11,Volver,9400000,87226613,12899867,2006,77826613,827.9426914893618,2000
4262,2006-03-11,Unknown,3700000,3355048,26403,2006,-344952,-9.323027027027027,2000
1033,2006-03-17,V for Vendetta,50000000,130214162,70511035,2006,80214162,160.428324,2000
2067,2006-03-17,She's the Man,25000000,55279608,33889159,2006,30279608,121.11843200000001,2000
3084,2006-03-17,Find Me Guilty,13000000,2898225,1173673,2006,-10101775,-77.70596153846154,2000
3680,2006-03-17,Thank You For Smoking,7500000,40016662,24793509,2006,32516662,433.55549333333335,2000
4407,2006-03-17,Sommersturm,3000000,95204,95204,2006,-2904796,-96.82653333333333,2000
1023,2006-03-24,Inside Man,50000000,185798265,88634237,2006,135798265,271.59653000000003,2000
2395,2006-03-24,Stay Alive,20000000,23187506,23086480,2006,3187506,15.937529999999999,2000
2694,2006-03-24,Larry the Cable Guy: Health Inspector,17000000,15680099,15680099,2006,-1319901,-7.764123529411765,2000
4437,2006-03-24,Boynton Beach Club,2900000,3127472,3127472,2006,227472,7.8438620689655165,2000
5070,2006-03-24,Lonesome Jim,500000,602789,154187,2006,102789,20.5578,2000
577,2006-03-31,Ice Age: The Meltdown,75000000,651899282,195330621,2006,576899282,769.1990426666667,2000
685,2006-03-31,Basic Instinct 2,70000000,35417162,5946136,2006,-34582838,-49.40405428571429,2000
2691,2006-03-31,ATL,17000000,21170563,21170563,2006,4170563,24.532723529411765,2000
2786,2006-03-31,Slither,15250000,12930343,7802450,2006,-2319657,-15.21086557377049,2000
4490,2006-03-31,Marilyn Hotchkiss' Ballroom Dancing and Charm School,2500000,497195,349132,2006,-2002805,-80.1122,2000
5112,2006-03-31,Brick,450000,4243996,2075743,2006,3793996,843.1102222222222,2000
4132,2006-04-05,Chinjeolhan geumjassi,4500000,23471871,211667,2006,18971871,421.5971333333333,2000
618,2006-04-08,Talladega Nights: The Ballad of Ricky Bobby,73000000,162870525,148213377,2006,89870525,123.11030821917808,2000
998,2006-04-08,Barnyard: The Original Party Animals,51000000,118583844,72779000,2006,67583844,132.51734117647058,2000
3627,2006-04-08,"Bon Cop, Bad Cop",8000000,12740705,12671300,2006,4740705,59.258812500000005,2000
3721,2006-04-08,The Descent,7000000,57051053,26024456,2006,50051053,715.0150428571428,2000
4190,2006-04-08,The Night Listener,4000000,10770993,7836393,2006,6770993,169.274825,2000
4579,2006-04-10,Shortbus,2000000,1985292,1985292,2006,-14708,-0.7354,2000
538,2006-04-14,The Wild,80000000,99010667,37384046,2006,19010667,23.76333375,2000
1297,2006-04-14,Scary Movie 4,40000000,178710620,90710620,2006,138710620,346.77655,2000
4951,2006-04-14,Hard Candy,950000,8267066,1024640,2006,7317066,770.2174736842105,2000
845,2006-04-21,The Sentinel,60000000,78080697,36280697,2006,18080697,30.134495,2000
1056,2006-04-21,Silent Hill,50000000,94704227,46982632,2006,44704227,89.408454,2000
2700,2006-04-21,American Dreamz,17000000,16510971,7314027,2006,-489029,-2.876641176470588,2000
4922,2006-04-21,In Her Line of Fire,1000000,884,884,2006,-999116,-99.9116,2000
927,2006-04-28,R.V.,55000000,87524497,71724497,2006,32524497,59.135449090909084,2000
2383,2006-04-28,Stick It,20000000,30399714,26910736,2006,10399714,51.99857,2000
2590,2006-04-28,United 93,18000000,77635035,31567134,2006,59635035,331.30575000000005,2000
3494,2006-04-28,The Lost City,9600000,5256839,2484186,2006,-4343161,-45.24126041666667,2000
3617,2006-04-28,Akeelah and the Bee,8000000,18959424,18848430,2006,10959424,136.99280000000002,2000
4371,2006-04-28,Water,3000000,11322573,5529144,2006,8322573,277.4191,2000
5373,2006-04-28,Grip: A Criminal's Story,12000,1336,1336,2006,-10664,-88.86666666666667,2000
5376,2006-04-28,Clean,10000,138711,138711,2006,128711,1287.1100000000001,2000
155,2006-05-05,Mission: Impossible III,150000000,397501348,133501348,2006,247501348,165.00089866666667,2000
1848,2006-05-05,Wu ji,30000000,35869934,669625,2006,5869934,19.566446666666668,2000
2491,2006-05-05,The Proposition,20000000,5313608,1903434,2006,-14686392,-73.43195999999999,2000
2901,2006-05-05,Hoot,15000000,8224998,8117637,2006,-6775002,-45.16668,2000
2983,2006-05-05,An American Haunting,14000000,30443277,16298046,2006,16443277,117.45197857142857,2000
3649,2006-05-05,Down in the Valley,8000000,973443,568932,2006,-7026557,-87.8319625,2000
3526,2006-05-12,Black Christmas,9000000,16235738,16235738,2006,7235738,80.39708888888889,2000
236,2006-05-19,The Da Vinci Code,125000000,767820459,217536138,2006,642820459,514.2563672,2000
493,2006-05-19,Over the Hedge,80000000,343397247,155019340,2006,263397247,329.24655875,2000
3625,2006-05-19,See No Evil,8000000,18828036,15032800,2006,10828036,135.35045000000002,2000
4845,2006-05-24,An Inconvenient Truth,1000000,52769915,24146161,2006,51769915,5176.9915,2000
32,2006-05-26,X-Men: The Last Stand,210000000,459359555,234362462,2006,249359555,118.74264523809524,2000
5385,2006-05-26,Cavite,7000,71644,70071,2006,64644,923.4857142857143,2000
2142,2006-06-01,BloodRayne,25000000,3605420,2405420,2006,-21394580,-85.57831999999999,2000
3216,2006-06-01,Fateless,12000000,196857,196857,2006,-11803143,-98.359525,2000
4030,2006-06-01,Grandma's Boy,5000000,6590172,6090172,2006,1590172,31.80344,2000
4097,2006-06-01,Hostel,4800000,82241110,47326473,2006,77441110,1613.3564583333332,2000
2036,2006-06-06,The Omen,25000000,119295584,54607383,2006,94295584,377.182336,2000
402,2006-06-10,The Departed,90000000,289660619,132384315,2006,199660619,221.84513222222222,2000
2734,2006-06-10,The Texas Chainsaw Massacre: The Beginning,16000000,50517763,39517763,2006,34517763,215.73601875000003,2000
2999,2006-06-10,Little Children,14000000,14121177,5463019,2006,121177,0.86555,2000
3346,2006-06-10,Employee of the Month,10000000,38364855,28444855,2006,28364855,283.64855,2000
4400,2006-06-10,Love's Abiding Joy,3000000,252726,252726,2006,-2747274,-91.5758,2000
459,2006-06-16,The Fast and the Furious: Tokyo Drift,85000000,157794205,62615510,2006,72794205,85.64024117647058,2000
857,2006-06-16,Garfield: A Tail of Two Kitties,60000000,147985373,28426747,2006,87985373,146.64228833333334,2000
1334,2006-06-16,The Lake House,40000000,114830111,52330111,2006,74830111,187.0752775,2000
1666,2006-06-16,Nacho Libre,32000000,99296462,80197993,2006,67296462,210.30144375,2000
5055,2006-06-16,Wordplay,500000,3177636,3121270,2006,2677636,535.5272,2000
478,2006-06-23,Click,82500000,237685089,137355633,2006,155185089,188.1031381818182,2000
3435,2006-06-23,Krrish,10000000,32430721,1430721,2006,22430721,224.30721,2000
4617,2006-06-23,Say Uncle,2000000,5361,5361,2006,-1994639,-99.73195,2000
19,2006-06-28,Superman Returns,232000000,374085065,200120000,2006,142085065,61.2435625,2000
4578,2006-06-28,Strangers with Candy,2000000,2077844,2072645,2006,77844,3.8922,2000
4873,2006-06-28,Who Killed the Electric Car?,1000000,1849392,1678874,2006,849392,84.9392,2000
5200,2006-06-28,The Motel,250000,51540,51540,2006,-198460,-79.384,2000
1516,2006-06-30,The Devil Wears Prada,35000000,326073155,124740460,2006,291073155,831.6375857142857,2000
1535,2006-07-04,The Benchwarmers,35000000,65063726,59843754,2006,30063726,85.89636,2000
1788,2006-07-04,Take the Lead,30000000,65390493,34742066,2006,35390493,117.96831,2000
1948,2006-07-04,Lucky Number Slevin,27000000,55495466,22495466,2006,28495466,105.53876296296296,2000
3808,2006-07-04,Friends with Money,6500000,18110152,13368437,2006,11610152,178.61772307692308,2000
4367,2006-07-04,Phat Girlz,3000000,7301115,7061128,2006,4301115,143.3705,2000
4779,2006-07-04,Simon,1300000,1738663,4055,2006,438663,33.743307692307695,2000
23,2006-07-07,Pirates of the Caribbean: Dead Man’s Chest,225000000,1066215812,423315812,2006,841215812,373.87369422222224,2000
2476,2006-07-07,A Scanner Darkly,20000000,7405084,5501616,2006,-12594916,-62.97458,2000
4900,2006-07-07,Once in a Lifetime: the Extraordinary Story of the New York Cosmos,1000000,215559,144601,2006,-784441,-78.4441,2000
755,2006-07-14,Little Man,64000000,101636047,58636047,2006,37636047,58.8063234375,2000
971,2006-07-14,"You, Me and Dupree",54000000,130402010,75802010,2006,76402010,141.4852037037037,2000
3460,2006-07-14,Edmond,10000000,241719,131719,2006,-9758281,-97.58281,2000
4054,2006-07-14,The Oh in Ohio,5000000,648183,418689,2006,-4351817,-87.03634,2000
592,2006-07-21,Monster House,75000000,141267370,73661010,2006,66267370,88.35649333333333,2000
601,2006-07-21,Lady in the Water,75000000,72785169,42285169,2006,-2214831,-2.9531080000000003,2000
1804,2006-07-21,My Super Ex-Girlfriend,30000000,60772856,22530295,2006,30772856,102.57618666666666,2000
3981,2006-07-21,Clerks II,5000000,27342246,24148068,2006,22342246,446.84492,2000
5246,2006-07-21,The Case of the Grinning Cat,200000,7033,7033,2006,-192967,-96.4835,2000
3600,2006-07-26,Little Miss Sunshine,8000000,100642353,59891098,2006,92642353,1158.0294125,2000
208,2006-07-28,Miami Vice,135000000,163818556,63478838,2006,28818556,21.34707851851852,2000
1202,2006-07-28,The Ant Bully,45000000,49610898,28142535,2006,4610898,10.24644,2000
4184,2006-07-28,Scoop,4000000,40103262,10525717,2006,36103262,902.58155,2000
2393,2006-08-09,The Covenant,20000000,38164784,23364784,2006,18164784,90.82392,2000
3911,2006-08-09,Tom yum goong,5700000,43044087,12044087,2006,37344087,655.1594210526316,2000
4596,2006-08-09,Sherrybaby,2000000,759504,199176,2006,-1240496,-62.0248,2000
351,2006-08-12,Blood Diamond,100000000,171377916,57377916,2006,71377916,71.377916,2000
458,2006-08-12,The Holiday,85000000,205190324,63280000,2006,120190324,141.40038117647057,2000
1338,2006-08-12,Apocalypto,40000000,121032272,50866635,2006,81032272,202.58067999999997,2000
2099,2006-08-12,Unaccompanied Minors,25000000,21970831,16655224,2006,-3029169,-12.116676,2000
1648,2006-08-18,Snakes on a Plane,33000000,62020814,34020814,2006,29020814,87.9418606060606,2000
2719,2006-08-18,The Illusionist,16500000,83792062,39868642,2006,67292062,407.83067878787875,2000
3543,2006-08-18,Trust the Man,9000000,2548378,1530535,2006,-6451622,-71.68468888888889,2000
3660,2006-08-18,10th & Wolf,8000000,143782,54702,2006,-7856218,-98.202725,2000
1327,2006-08-25,Invincible,40000000,58501127,57806952,2006,18501127,46.2528175,2000
2662,2006-08-25,Beerfest,17500000,20159316,19185184,2006,2659316,15.196091428571428,2000
2881,2006-08-25,Idlewild,15000000,12669914,12669914,2006,-2330086,-15.533906666666667,2000
4964,2006-08-25,The Quiet,900000,381420,381420,2006,-518580,-57.620000000000005,2000
5163,2006-08-25,Old Joy,300000,399908,255923,2006,99908,33.30266666666667,2000
636,2006-09-06,Cars,70000000,461651246,244082982,2006,391651246,559.5017799999999,2000
3359,2006-09-06,A Prairie Home Companion,10000000,26716191,20342852,2006,16716191,167.16191,2000
727,2006-09-08,World Trade Center,65000000,163295654,70278893,2006,98295654,151.22408307692308,2000
863,2006-09-15,The Black Dahlia,60000000,49238525,22672813,2006,-10761475,-17.935791666666667,2000
1780,2006-09-15,Gridiron Gang,30000000,41457834,38432823,2006,11457834,38.19278,2000
4446,2006-09-15,Artie Lange's Beer League,2800000,475000,475000,2006,-2325000,-83.03571428571429,2000
869,2006-09-22,Flyboys,60000000,14816379,13090630,2006,-45183621,-75.30603500000001,2000
963,2006-09-22,All the King's Men,55000000,9521458,7221458,2006,-45478542,-82.68825818181818,2000
1629,2006-09-22,Bandidas,35000000,19282590,0,2006,-15717410,-44.906885714285714,2000
2647,2006-09-22,Renaissance,18000000,2401413,70644,2006,-15598587,-86.65881666666667,2000
3245,2006-09-22,Jackass: Number Two,11000000,85278712,72778712,2006,74278712,675.2610181818181,2000
3867,2006-09-22,La science des rêves,6000000,15137932,4670644,2006,9137932,152.29886666666667,2000
4326,2006-09-22,Feast,3200000,690872,56131,2006,-2509128,-78.41025,2000
3847,2006-09-27,The Last King of Scotland,6000000,49155371,17606684,2006,43155371,719.2561833333333,2000
454,2006-09-29,Open Season,85000000,191932158,85105259,2006,106932158,125.8025388235294,2000
661,2006-09-29,The Guardian,70000000,94973540,55011732,2006,24973540,35.67648571428572,2000
2414,2006-09-29,School for Scoundrels,20000000,17807569,17807569,2006,-2192431,-10.962155,2000
2810,2006-09-30,The Queen,15000000,128885873,56441711,2006,113885873,759.2391533333333,2000
517,2006-10-02,The Pink Panther,80000000,158926474,82226474,2006,78926474,98.65809250000001,2000
1040,2006-10-02,Curious George,50000000,71052604,58640119,2006,21052604,42.105208,2000
1051,2006-10-02,Firewall,50000000,82751189,48751189,2006,32751189,65.50237800000001,2000
2037,2006-10-02,Final Destination 3,25000000,112798051,54098051,2006,87798051,351.192204,2000
4613,2006-10-02,London,2000000,12667,12667,2006,-1987333,-99.36665,2000
813,2006-10-03,The Shaggy Dog,60000000,87123569,61123569,2006,27123569,45.20594833333333,2000
1022,2006-10-03,Failure to Launch,50000000,128402901,88715192,2006,78402901,156.805802,2000
2681,2006-10-03,The Hills Have Eyes,17000000,70355813,41778863,2006,53355813,313.85772352941177,2000
1614,2006-10-11,A Good Year,35000000,42064105,7459300,2006,7064105,20.18315714285714,2000
1775,2006-10-11,Stranger Than Fiction,30000000,53572822,40435190,2006,23572822,78.57607333333333,2000
2715,2006-10-11,FUR: An Imaginary Portrait of Diane Arbus,16800000,2281089,223202,2006,-14518911,-86.42208928571429,2000
3280,2006-10-11,Copying Beethoven,11000000,6586324,355968,2006,-4413676,-40.12432727272727,2000
3889,2006-10-11,Come Early Morning,6000000,119452,119452,2006,-5880548,-98.00913333333334,2000
4573,2006-10-11,Harsh Times,2000000,6225304,3337931,2006,4225304,211.26520000000002,2000
1427,2006-10-13,Alex Rider: Operation Stormbreaker,40000000,20722450,659210,2006,-19277550,-48.193875000000006,2000
2353,2006-10-13,The Grudge 2,20000000,70743839,39143839,2006,50743839,253.71919499999998,2000
2358,2006-10-13,Man of the Year,20000000,41342180,37442180,2006,21342180,106.71090000000001,2000
2436,2006-10-13,One Night with the King,20000000,13725032,13395961,2006,-6274968,-31.37484,2000
2864,2006-10-13,The Marine,15000000,22165608,18844784,2006,7165608,47.77072,2000
3086,2006-10-13,Infamous,13000000,2613717,1151330,2006,-10386283,-79.89448461538461,2000
4103,2006-10-13,Driving Lessons,4700000,239962,239962,2006,-4460038,-94.89442553191489,2000
5148,2006-10-18,51 Birch Street,350000,84689,84689,2006,-265311,-75.80314285714286,2000
983,2006-10-20,Flags of Our Fathers,53000000,63657941,33602376,2006,10657941,20.109322641509433,2000
1333,2006-10-20,The Prestige,40000000,104407366,53089891,2006,64407366,161.018415,2000
1396,2006-10-20,Marie Antoinette,40000000,60862471,15962471,2006,20862471,52.1561775,2000
2859,2006-10-20,Flicka,15000000,21896367,21000147,2006,6896367,45.97578,2000
3187,2006-10-20,Running With Scissors,12000000,8706701,6860000,2006,-3293299,-27.444158333333334,2000
2367,2006-10-27,Babel,20000000,132121212,34302837,2006,112121212,560.6060600000001,2000
3003,2006-10-27,Catch a Fire,14000000,5782198,4299773,2006,-8217802,-58.69858571428571,2000
3307,2006-10-27,Saw III,10000000,163876815,80238724,2006,153876815,1538.7681499999999,2000
1602,2006-11-08,Zoom,35000000,12506188,11989328,2006,-22493812,-64.26803428571428,2000
2305,2006-11-08,Pulse,20500000,30241435,20264436,2006,9741435,47.51919512195122,2000
3133,2006-11-08,Step Up,12000000,110989157,65328121,2006,98989157,824.9096416666667,2000
3289,2006-11-08,Kabhi Alvida Naa Kehna,10750000,32575443,3275443,2006,21825443,203.02737674418606,2000
4256,2006-11-08,Casa de Areia,3750000,1178175,539285,2006,-2571825,-68.582,2000
5012,2006-11-08,Half Nelson,700000,4911725,2697938,2006,4211725,601.675,2000
5114,2006-11-08,Conversations with Other Women,450000,1297745,379418,2006,847745,188.38777777777779,2000
323,2006-11-17,Casino Royale,102000000,594420283,167365000,2006,492420283,482.7649833333333,2000
440,2006-11-17,Happy Feet,85000000,385000317,198000317,2006,300000317,352.9415494117647,2000
2994,2006-11-17,Bobby,14000000,20597806,11242801,2006,6597806,47.127185714285716,2000
3190,2006-11-17,For Your Consideration,12000000,5549923,5549923,2006,-6450077,-53.75064166666667,2000
4196,2006-11-17,Let's Go to Prison,4000000,4630045,4630045,2006,630045,15.751124999999998,2000
4261,2006-11-21,The History Boys,3700000,13447998,2730296,2006,9747998,263.4594054054054,2000
526,2006-11-22,Déjà Vu,80000000,181038616,64038616,2006,101038616,126.29827,2000
999,2006-11-22,Deck the Halls,51000000,46815807,35093569,2006,-4184193,-8.2043,2000
1609,2006-11-22,The Fountain,35000000,15461638,10144010,2006,-19538362,-55.82389142857143,2000
3555,2006-11-22,Opal Dreams,9000000,14443,14443,2006,-8985557,-99.83952222222221,2000
3592,2006-11-24,Kurtlar vadisi - Irak,8300000,24906717,0,2006,16606717,200.08092771084338,2000
5168,2006-12-04,Sisters in Law,300000,33312,33312,2006,-266688,-88.896,2000
124,2006-12-05,Poseidon,160000000,181674817,60674817,2006,21674817,13.546760625000001,2000
1654,2006-12-05,Goal! The Dream Begins,33000000,27610873,4283255,2006,-5389127,-16.330687878787877,2000
1916,2006-12-05,Just My Luck,28000000,38159905,17326650,2006,10159905,36.285374999999995,2000
3773,2006-12-05,Wah-Wah,7000000,463039,234750,2006,-6536961,-93.38515714285714,2000
4037,2006-12-05,Keeping Up with the Steins,5000000,4414753,4339241,2006,-585247,-11.70494,2000
4824,2006-12-05,Dead Man's Shoes,1125000,414736,6408,2006,-710264,-63.13457777777778,2000
345,2006-12-15,Eragon,100000000,249488115,75030163,2006,149488115,149.48811500000002,2000
479,2006-12-15,Charlotte's Web,82500000,143985708,82985708,2006,61485708,74.5281309090909,2000
587,2006-12-15,Dreamgirls,75000000,155708695,103365956,2006,80708695,107.61159333333335,2000
910,2006-12-15,The Pursuit of Happyness,55000000,307325633,162586036,2006,252325633,458.7738781818182,2000
1689,2006-12-15,The Good German,32000000,1308696,1308696,2006,-30691304,-95.910325,2000
2557,2006-12-15,Indigènes,18900000,26063572,320700,2006,7163572,37.902497354497356,2000
2167,2006-12-20,Rocky Balboa,24000000,156229050,70269899,2006,132229050,550.954375,2000
2524,2006-12-20,The Painted Veil,19400000,15118795,8060487,2006,-4281205,-22.068067010309278,2000
3066,2006-12-20,Letters from Iwo Jima,13000000,67867998,13756082,2006,54867998,422.0615230769231,2000
1226,2006-12-21,Man cheng jin dai huang jin jia,45000000,76904429,6566773,2006,31904429,70.89873111111112,2000
3872,2006-12-21,Venus,6000000,7818479,3347411,2006,1818479,30.307983333333333,2000
283,2006-12-22,Night at the Museum,110000000,579446407,250863268,2006,469446407,426.76946090909087,2000
736,2006-12-22,We Are Marshall,65000000,43545364,43545364,2006,-21454636,-33.0071323076923,2000
570,2006-12-25,Children of Men,76000000,69845011,35552383,2006,-6154989,-8.098669736842105,2000
1934,2006-12-25,Notes on a Scandal,27500000,50578411,17510118,2006,23078411,83.92149454545455,2000
757,2006-12-27,Perfume: The Story of a Murderer,63700000,133603463,2223293,2006,69903463,109.73856043956043,2000
1847,2006-12-29,Miss Potter,30000000,35891257,3005605,2006,5891257,19.637523333333334,2000
2735,2006-12-29,El Laberinto del Fauno,16000000,87041569,37634615,2006,71041569,444.00980625,2000
4315,2006-12-29,The Dead Girl,3300000,19875,19875,2006,-3280125,-99.39772727272728,2000
1270,2006-12-31,Les Bronzés 3: amis pour la vie,42000000,83833602,0,2006,41833602,99.6038142857143,2000
4926,2006-12-31,Loving Annabelle,1000000,5382,0,2006,-994618,-99.4618,2000
5085,2006-12-31,Fengkuang de Shitou,500000,3000000,0,2006,2500000,500.0,2000
1928,2007-01-06,Knocked Up,27500000,219265952,148761765,2007,191765952,697.3307345454546,2000
3541,2007-01-06,Gracie,9000000,3922043,2956339,2007,-5077957,-56.42174444444444,2000
4950,2007-01-06,And Then Came Love,989000,8158,8158,2007,-980842,-99.17512639029323,2000
4915,2007-01-17,Alone with Her,1000000,844377,10787,2007,-155623,-15.5623,2000
2351,2007-01-26,Epic Movie,20000000,86858578,39739367,2007,66858578,334.29289,2000
2684,2007-01-26,Smokin' Aces,17000000,57263440,35662731,2007,40263440,236.84376470588236,2000
2915,2007-01-26,Blood and Chocolate,15000000,6551310,3526588,2007,-8448690,-56.324600000000004,2000
1438,2007-02-02,Because I Said So,39000000,69538833,42674040,2007,30538833,78.30470000000001,2000
2737,2007-02-02,The Messengers,16000000,53774833,35374833,2007,37774833,236.09270625,2000
3760,2007-02-02,Factory Girl,7000000,1661464,1661464,2007,-5338536,-76.2648,2000
471,2007-02-03,Zodiac,85000000,83080084,33080084,2007,-1919916,-2.258724705882353,2000
776,2007-02-03,Wild Hogs,60000000,253555383,168213584,2007,193555383,322.592305,2000
2892,2007-02-03,Black Snake Moan,15000000,10951153,9396870,2007,-4048847,-26.992313333333335,2000
4709,2007-02-05,Waitress,1500000,22217183,19097550,2007,20717183,1381.1455333333333,2000
133,2007-02-07,Transformers,151000000,708272592,319246193,2007,557272592,369.0546966887417,2000
159,2007-02-11,Bee Movie,150000000,287594577,126631277,2007,137594577,91.729718,2000
334,2007-02-11,American Gangster,100000000,267985456,130164645,2007,167985456,167.985456,2000
1958,2007-02-11,The Martian Child,27000000,9352089,7500310,2007,-17647911,-65.36263333333333,2000
1339,2007-02-14,Music and Lyrics,40000000,146300356,50572589,2007,106300356,265.75088999999997,2000
259,2007-02-16,Ghost Rider,120000000,229545589,115802596,2007,109545589,91.28799083333334,2000
2020,2007-02-16,Bridge to Terabithia,25000000,137984788,82234139,2007,112984788,451.93915200000004,2000
1675,2007-02-23,The Number 23,32000000,77593167,35193167,2007,45593167,142.478646875,2000
3068,2007-02-23,The Astronaut Farmer,13000000,11141213,11003643,2007,-1858787,-14.298361538461538,2000
3360,2007-02-23,Reno 911!: Miami,10000000,21851362,20342161,2007,11851362,118.51362,2000
1547,2007-03-07,License to Wed,35000000,70187088,43799818,2007,35187088,100.53453714285713,2000
213,2007-03-08,The Bourne Ultimatum,130000000,442161562,227471070,2007,312161562,240.12427846153847,2000
2112,2007-03-08,Hot Rod,25000000,14334401,13938332,2007,-10665599,-42.662396,2000
2720,2007-03-08,Becoming Jane,16500000,39380876,18663911,2007,22880876,138.67197575757575,2000
3947,2007-03-08,The Ten,5250000,786677,769726,2007,-4463323,-85.01567619047619,2000
4059,2007-03-08,"Gandhi, My Father",5000000,1375194,240425,2007,-3624806,-72.49611999999999,2000
3896,2007-03-10,Lake of Fire,6000000,26007,25317,2007,-5973993,-99.56654999999999,2000
1431,2007-03-16,Nomad,40000000,79123,79123,2007,-39920877,-99.8021925,2000
2344,2007-03-16,Premonition,20000000,81461343,47852604,2007,61461343,307.306715,2000
2992,2007-03-16,I Think I Love My Wife,14000000,13205411,12559771,2007,-794589,-5.675635714285714,2000
3590,2007-03-16,The Wind That Shakes the Barley,8300000,25670174,1829142,2007,17370174,209.27920481927708,2000
831,2007-03-23,Shooter,60000000,95538560,47003582,2007,35538560,59.23093333333333,2000
1540,2007-03-23,TMNT,35000000,96096018,54149098,2007,61096018,174.56005142857143,2000
2406,2007-03-23,Reign Over Me,20000000,20081987,19661987,2007,81987,0.409935,2000
2860,2007-03-23,The Hills Have Eyes II,15000000,37466538,20804166,2007,22466538,149.77692,2000
3587,2007-03-23,Namastey London,8400000,6831069,1207007,2007,-1568931,-18.67775,2000
4772,2007-03-23,Journey from the Fall,1300000,635305,635305,2007,-664695,-51.130384615384614,2000
769,2007-03-30,Blades of Glory,61000000,145594548,118594548,2007,84594548,138.6795868852459,2000
9,2007-04-05,Spider-Man 3,258000000,890875303,336530303,2007,632875303,245.3005050387597,2000
966,2007-04-05,Lucky You,55000000,6521829,5755286,2007,-48478171,-88.1421290909091,2000
3076,2007-04-05,"Paris, je t'aime",13000000,5175088,4857374,2007,-7824912,-60.19163076923076,2000
3411,2007-04-07,Rescue Dawn,10000000,7037886,5490423,2007,-2962114,-29.62114,2000
3666,2007-04-09,The Death and Life of Bobby Z,8000000,414617,0,2007,-7585383,-94.8172875,2000
2324,2007-04-13,Disturbia,20000000,118537627,80818974,2007,98537627,492.68813500000005,2000
2782,2007-04-13,Slow Burn,15500000,1237615,1237615,2007,-14262385,-92.01538709677419,2000
4997,2007-04-13,Aqua Teen Hunger Force Colon Movie Film for Theaters,750000,5520368,5520368,2007,4770368,636.0490666666666,2000
2743,2007-04-20,Hot Fuzz,16000000,81742618,23618786,2007,65742618,410.89136249999996,2000
3296,2007-04-20,In the Land of Women,10500000,14140402,11052958,2007,3640402,34.67049523809524,2000
3288,2007-04-27,Jindabyne,10800000,2862544,399879,2007,-7937456,-73.49496296296296,2000
3700,2007-04-27,Ta Ra Rum Pum,7400000,9443864,872643,2007,2043864,27.619783783783785,2000
1147,2007-05-01,Happily N'Ever After,47000000,37923818,15849032,2007,-9076182,-19.311025531914893,2000
2291,2007-05-01,Freedom Writers,21000000,43632609,36605602,2007,22632609,107.77432857142857,2000
2461,2007-05-01,Code Name: The Cleaner,20000000,8135024,8135024,2007,-11864976,-59.32488,2000
4510,2007-05-01,Thr3e,2400000,1420418,1008849,2007,-979582,-40.815916666666666,2000
1382,2007-05-04,The Reaping,40000000,62226214,25126214,2007,22226214,55.565535,2000
4734,2007-05-09,I Want Someone To Eat Cheese With,1500000,194568,194568,2007,-1305432,-87.02879999999999,2000
2280,2007-05-10,Michael Clayton,21500000,92987651,49033882,2007,71487651,332.5007023255814,2000
2939,2007-05-10,The Good Night,15000000,22441,22441,2007,-14977559,-99.85039333333333,2000
5075,2007-05-10,Finishing the Game,500000,53201,52850,2007,-446799,-89.3598,2000
3708,2007-05-12,Juno,7000000,231450102,143495265,2007,224450102,3206.430028571429,2000
116,2007-05-17,Shrek the Third,160000000,807330936,322719944,2007,647330936,404.581835,2000
3459,2007-05-18,Severance,10000000,5950002,137221,2007,-4049998,-40.49998,2000
3655,2007-05-18,The Wendell Baker Story,8000000,127188,127188,2007,-7872812,-98.41015,2000
3,2007-05-24,Pirates of the Caribbean: At World’s End,300000000,963420425,309420425,2007,663420425,221.14014166666664,2000
4193,2007-05-25,Bug,4000000,8302995,7006708,2007,4302995,107.574875,2000
984,2007-06-04,Grindhouse,53000000,50187789,25031037,2007,-2812211,-5.306058490566038,2000
2132,2007-06-04,The Hoax,25000000,7164995,7164995,2007,-17835005,-71.34002000000001,2000
2272,2007-06-04,Zwartboek,22000000,27238354,4398532,2007,5238354,23.8107,2000
257,2007-06-15,Fantastic Four: Rise of the Silver Surfer,120000000,288215319,131921738,2007,168215319,140.1794325,2000
1850,2007-06-15,DOA: Dead or Alive,30000000,7755686,480314,2007,-22244314,-74.14771333333333,2000
2390,2007-06-15,Nancy Drew,20000000,30703845,25584685,2007,10703845,53.519225000000006,2000
3652,2007-06-15,Fido,8000000,456814,298110,2007,-7543186,-94.28982500000001,2000
5165,2007-06-15,Pierrot le fou,300000,70807,70807,2007,-229193,-76.39766666666667,2000
5249,2007-06-15,The Trials of Darryl Hunt,200000,1217,1217,2007,-198783,-99.3915,2000
92,2007-06-22,Evan Almighty,175000000,174131329,100289690,2007,-868671,-0.4963834285714286,2000
2228,2007-06-22,1408,22500000,131263370,71985628,2007,108763370,483.39275555555554,2000
2895,2007-06-22,A Mighty Heart,15000000,19153568,9176787,2007,4153568,27.69045333333333,2000
3520,2007-06-22,Sicko,9000000,36535837,24538513,2007,27535837,305.95374444444445,2000
4204,2007-06-22,You Kill Me,4000000,3858964,2426851,2007,-141036,-3.5259,2000
287,2007-06-27,Live Free or Die Hard,110000000,382288147,134529403,2007,272288147,247.53467909090907,2000
144,2007-06-29,Ratatouille,150000000,626549695,206445654,2007,476549695,317.69979666666666,2000
4657,2007-06-29,Chacun sa nuit,1900000,139317,18435,2007,-1760683,-92.66752631578947,2000
1134,2007-07-09,3:10 to Yuma,48000000,71171825,53606916,2007,23171825,48.27463541666667,2000
1426,2007-07-09,The Hunting Party,40000000,7729552,876671,2007,-32270448,-80.67612,2000
3279,2007-07-09,Romance and Cigarettes,11000000,3231251,551002,2007,-7768749,-70.62499090909091,2000
3441,2007-07-09,The Brothers Solomon,10000000,900926,900926,2007,-9099074,-90.99074,2000
4586,2007-07-09,In the Shadow of the Moon,2000000,1134358,1134358,2007,-865642,-43.2821,2000
4736,2007-07-09,Hatchet,1500000,240396,175281,2007,-1259604,-83.9736,2000
36,2007-07-12,The Golden Compass,205000000,367262558,70107728,2007,162262558,79.15246731707317,2000
1761,2007-07-12,Atonement,30000000,129779728,50980159,2007,99779728,332.5990933333333,2000
4465,2007-07-12,Timber Falls,2600000,71248,0,2007,-2528752,-97.2596923076923,2000
4985,2007-07-18,Cama adentro,800000,200433,200433,2007,-599567,-74.945875,2000
450,2007-07-20,I Now Pronounce You Chuck and Larry,85000000,185708462,119725280,2007,100708462,118.48054352941178,2000
585,2007-07-20,Hairspray,75000000,203035572,118871849,2007,128035572,170.714096,2000
1421,2007-07-20,Sunshine,40000000,32030610,3688560,2007,-7969390,-19.923475,2000
4514,2007-07-25,This is England,2380000,8739576,327919,2007,6359576,267.2090756302521,2000
622,2007-07-27,The Simpsons Movie,72500000,527071022,183135014,2007,454571022,626.9945131034483,2000
1903,2007-07-27,No Reservations,28000000,91943956,43107979,2007,63943956,228.37127142857142,2000
2279,2007-07-27,Molière,21600000,791154,635733,2007,-20808846,-96.33725,2000
3748,2007-07-27,Who's Your Caddy?,7000000,5694308,5694308,2007,-1305692,-18.652742857142858,2000
4584,2007-07-27,No End In Sight,2000000,1433319,1433319,2007,-566681,-28.334049999999998,2000
350,2007-08-06,Surf's Up,100000000,145395745,58867694,2007,45395745,45.395745,2000
451,2007-08-06,Ocean's Thirteen,85000000,311744465,117144465,2007,226744465,266.75819411764707,2000
2780,2007-08-06,La Môme,15500000,88611837,10299782,2007,73111837,471.68927096774195,2000
3681,2007-08-06,Hostel: Part II,7500000,33606409,17544812,2007,26106409,348.08545333333336,2000
3850,2007-08-08,Daddy Day Camp,6000000,18209872,13235267,2007,12209872,203.49786666666665,2000
553,2007-08-17,The Invasion,80000000,40147042,15074191,2007,-39852958,-49.8161975,2000
702,2007-08-17,The Last Legion,67000000,25357771,5932060,2007,-41642229,-62.152580597014925,2000
2459,2007-08-17,Death at a Funeral,20000000,46790428,8580428,2007,26790428,133.95213999999999,2000
2656,2007-08-17,Superbad,17500000,169955142,121463226,2007,152455142,871.1722399999999,2000
2069,2007-08-24,Mr. Bean’s Holiday,25000000,234981342,33302167,2007,209981342,839.9253679999999,2000
2087,2007-08-24,War,25000000,40686409,22486409,2007,15686409,62.745636000000005,2000
3077,2007-08-24,Resurrecting the Champ,13000000,3260555,3172382,2007,-9739445,-74.91880769230768,2000
3302,2007-08-24,September Dawn,10100000,1066555,1066555,2007,-9033445,-89.4400495049505,2000
4497,2007-08-24,Eye of the Dolphin,2500000,72260,72210,2007,-2427740,-97.1096,2000
2453,2007-08-31,Death Sentence,20000000,16907831,9534258,2007,-3092169,-15.460845,2000
2809,2007-08-31,Halloween,15000000,77514401,58269151,2007,62514401,416.7626733333333,2000
4138,2007-08-31,Fong juk,4500000,51957,51957,2007,-4448043,-98.84540000000001,2000
1080,2007-09-02,Hannibal Rising,50000000,80583311,27669725,2007,30583311,61.166622000000004,2000
4528,2007-09-02,The Last Sin Eater,2200000,388390,388390,2007,-1811610,-82.34590909090909,2000
4554,2007-09-02,Das Leben der Anderen,2000000,81197047,11284657,2007,79197047,3959.85235,2000
775,2007-09-03,300,60000000,454161935,210614939,2007,394161935,656.9365583333333,2000
3200,2007-09-03,Gwoemul,12000000,92618117,2201923,2007,80618117,671.8176416666668,2000
3539,2007-09-03,The Ultimate Gift,9000000,3438735,3438735,2007,-5561265,-61.79183333333334,2000
3578,2007-09-03,The Namesake,8500000,20288774,13610521,2007,11788774,138.6914588235294,2000
1598,2007-09-11,Lions for Lambs,35000000,63211088,14998070,2007,28211088,80.60310857142858,2000
2027,2007-09-11,No Country for Old Men,25000000,164051250,74273505,2007,139051250,556.205,2000
4404,2007-09-11,Holly,3000000,163069,163069,2007,-2836931,-94.56436666666667,2000
1101,2007-09-14,Eastern Promises,50000000,56077088,17181265,2007,6077088,12.154176,2000
1206,2007-09-14,Across the Universe,45000000,29367143,24343673,2007,-15632857,-34.73968222222222,2000
1685,2007-09-14,D-War,32000000,79915361,10977721,2007,47915361,149.73550312499998,2000
2220,2007-09-14,In the Valley of Elah,23000000,24489150,6777741,2007,1489150,6.474565217391303,2000
3449,2007-09-14,King of California,10000000,1165102,268461,2007,-8834898,-88.34898,2000
4287,2007-09-14,Ira and Abby,3500000,221096,221096,2007,-3278904,-93.68297142857142,2000
1192,2007-09-21,Resident Evil: Extinction,45000000,146162920,50648679,2007,101162920,224.8064888888889,2000
1843,2007-09-21,The Assassination of Jesse James by the Coward Robert Ford,30000000,15313631,3909149,2007,-14686369,-48.95456333333333,2000
2065,2007-09-21,Good Luck Chuck,25000000,59183821,35017297,2007,34183821,136.73528399999998,2000
2411,2007-09-21,Into the Wild,20000000,56822960,18354356,2007,36822960,184.1148,2000
2722,2007-09-21,Sydney White,16500000,13636339,11892415,2007,-2863661,-17.35552121212121,2000
625,2007-09-28,The Kingdom,72500000,86509602,47467250,2007,14009602,19.323588965517242,2000
2234,2007-09-28,The Game Plan,22000000,146590987,90648202,2007,124590987,566.3226681818182,2000
2911,2007-09-28,Se jie,15000000,65261291,4604982,2007,50261291,335.0752733333333,2000
3215,2007-09-28,Trade,12000000,1513388,214202,2007,-10486612,-87.38843333333334,2000
76,2007-10-08,Rush Hour 3,180000000,256585882,140125968,2007,76585882,42.54771222222222,2000
667,2007-10-08,Stardust,70000000,137022245,38634938,2007,67022245,95.74606428571428,2000
3822,2007-10-10,Control,6400000,8902141,871577,2007,2502141,39.095953125,2000
1778,2007-10-19,30 Days of Night,30000000,80276156,39568996,2007,50276156,167.58718666666667,2000
1935,2007-10-19,Rendition,27500000,26939925,9736045,2007,-560075,-2.036636363636364,2000
2544,2007-10-19,"Gone, Baby, Gone",19000000,34352162,20300218,2007,15352162,80.80085263157895,2000
2765,2007-10-19,Things We Lost in the Fire,16000000,8120148,3287315,2007,-7879852,-49.249075,2000
3440,2007-10-19,The Ten Commandments,10000000,1051907,952820,2007,-8948093,-89.48093,2000
4112,2007-10-19,Out of the Blue,4600000,731767,728,2007,-3868233,-84.09202173913044,2000
4891,2007-10-19,Wristcutters: A Love Story,1000000,473769,446165,2007,-526231,-52.6231,2000
5032,2007-10-19,Arnolds Park,600000,23616,23616,2007,-576384,-96.06400000000001,2000
3311,2007-10-26,Saw IV,10000000,135759694,63300095,2007,125759694,1257.59694,2000
4312,2007-10-26,Bella,3300000,12405473,8093373,2007,9105473,275.9234242424243,2000
2408,2007-11-05,Georgia Rule,20000000,20819601,18882880,2007,819601,4.098005,2000
2846,2007-11-05,28 Weeks Later,15000000,64232714,28638916,2007,49232714,328.21809333333334,2000
3650,2007-11-05,Brooklyn Rules,8000000,458232,458232,2007,-7541768,-94.27210000000001,2000
4739,2007-11-05,The Salon,1500000,139084,139084,2007,-1360916,-90.72773333333333,2000
137,2007-11-07,Harry Potter and the Order of the Phoenix,150000000,942943935,292004738,2007,792943935,528.6292900000001,2000
2710,2007-11-14,Southland Tales,17000000,364607,275380,2007,-16635393,-97.85525294117647,2000
164,2007-11-16,Beowulf,150000000,194995215,82195215,2007,44995215,29.99681,2000
1227,2007-11-16,Love in the Time of Cholera,45000000,31077418,4617608,2007,-13922582,-30.93907111111111,2000
4068,2007-11-16,Redacted,5000000,861325,65388,2007,-4138675,-82.7735,2000
448,2007-11-21,Enchanted,85000000,340384141,127706877,2007,255384141,300.4519305882353,2000
2072,2007-11-21,August Rush,25000000,66015869,31664162,2007,41015869,164.063476,2000
2483,2007-11-21,I'm Not There,20000000,12397613,4017609,2007,-7602387,-38.011935,2000
2660,2007-11-21,Hitman,17500000,99135571,39687694,2007,81635571,466.48897714285715,2000
3042,2007-11-21,This Christmas,13000000,49733545,49121934,2007,36733545,282.56573076923075,2000
3056,2007-11-21,The Mist,13000000,57189408,25593755,2007,44189408,339.9185230769231,2000
3533,2007-11-28,The Savages,9000000,10642023,6623082,2007,1642023,18.244699999999998,2000
2998,2007-11-30,Le Scaphandre et le Papillon,14000000,22754472,5990075,2007,8754472,62.53194285714285,2000
3566,2007-11-30,Awake,8600000,32968648,14373825,2007,24368648,283.35637209302325,2000
552,2007-12-01,Arthur et les Minimoys,80000000,113325743,15132763,2007,33325743,41.65717875,2000
2965,2007-12-01,Stomp the Yard,14000000,75525718,61356221,2007,61525718,439.46941428571427,2000
958,2007-12-10,Elizabeth: The Golden Age,55000000,74870866,16285240,2007,19870866,36.12884727272727,2000
1912,2007-12-10,We Own the Night,28000000,55307857,28563179,2007,27307857,97.52806071428571,2000
2811,2007-12-10,Why Did I Get Married?,15000000,55934178,55204525,2007,40934178,272.89452,2000
3108,2007-12-10,Lars and the Real Girl,12500000,11277119,5956480,2007,-1222881,-9.783047999999999,2000
140,2007-12-14,I am Legend,150000000,585532684,256393010,2007,435532684,290.35512266666666,2000
907,2007-12-14,Alvin and the Chipmunks,55000000,362605033,217326974,2007,307605033,559.2818781818182,2000
1858,2007-12-14,Goodbye Bafana,30000000,2717302,0,2007,-27282698,-90.94232666666666,2000
2422,2007-12-14,The Kite Runner,20000000,74180745,15800078,2007,54180745,270.903725,2000
5202,2007-12-14,Shotgun Stories,250000,284174,46026,2007,34174,13.6696,2000
594,2007-12-21,Charlie Wilson's War,75000000,119512771,66661095,2007,44512771,59.35036133333333,2000
1591,2007-12-21,Walk Hard: The Dewey Cox Story,35000000,20606053,18317151,2007,-14393947,-41.12556285714285,2000
1752,2007-12-21,P.S. I Love You,30000000,155769678,53695808,2007,125769678,419.23226,2000
3473,2007-12-21,Blonde Ambition,10000000,1537479,6422,2007,-8462521,-84.62521,2000
1168,2007-12-25,The Bucket List,45000000,174810815,93466502,2007,129810815,288.46847777777776,2000
1351,2007-12-25,Aliens vs. Predator - Requiem,40000000,128884494,41797066,2007,88884494,222.21123500000002,2000
1352,2007-12-25,The Water Horse: Legend of the Deep,40000000,103429755,40412817,2007,63429755,158.5743875,2000
2841,2007-12-25,The Great Debaters,15000000,30261293,30226144,2007,15261293,101.74195333333333,2000
3702,2007-12-25,Persepolis,7300000,25397460,4443403,2007,18097460,247.9104109589041,2000
2054,2007-12-26,There Will Be Blood,25000000,77208711,40222514,2007,52208711,208.83484399999998,2000
4192,2007-12-28,El orfanato,4000000,79250193,7159147,2007,75250193,1881.254825,2000
1927,2007-12-31,Alatriste,28000000,22860477,0,2007,-5139523,-18.355439285714287,2000
2665,2007-12-31,Taxi 4,17500000,60865364,0,2007,43365364,247.80208,2000
2723,2007-12-31,Arn - Tempelriddaren,16500000,21404122,0,2007,4904122,29.721951515151517,2000
2470,2008-01-02,Strange Wilderness,20000000,6947084,6575282,2008,-13052916,-65.26458000000001,2000
3148,2008-01-02,The Eye,12000000,57577765,31418697,2008,45577765,379.81470833333333,2000
3397,2008-01-02,Over Her Dead Body,10000000,21596074,7570127,2008,11596074,115.96074,2000
3801,2008-01-02,Hannah Montana/Miley Cyrus: Best of Both Worlds Concert Tour,6500000,70712099,65281781,2008,64212099,987.8784461538462,2000
4698,2008-01-02,Sukkar banat,1600000,14253760,1060591,2008,12653760,790.86,2000
142,2008-01-07,Hancock,150000000,624234272,227946274,2008,474234272,316.15618133333334,2000
91,2008-01-08,The Mummy: Tomb of the Dragon Emperor,175000000,405760225,102491776,2008,230760225,131.8629857142857,2000
2297,2008-01-08,Swing Vote,21000000,17589867,16289867,2008,-3410133,-16.23872857142857,2000
2935,2008-01-08,Midnight Meat Train,15000000,1590246,73548,2008,-13409754,-89.39836,2000
4869,2008-01-08,Frozen River,1000000,6030129,2511476,2008,5030129,503.01289999999995,2000
4476,2008-01-10,Religulous,2500000,13881317,13011160,2008,11381317,455.25268,2000
1730,2008-01-18,27 Dresses,30000000,160247805,76808654,2008,130247805,434.15935,2000
2022,2008-01-18,Cloverfield,25000000,171302226,80048433,2008,146302226,585.208904,2000
2254,2008-01-18,Mad Money,22000000,25044057,20668843,2008,3044057,13.836622727272726,2000
4095,2008-01-18,All Hat,4900000,15198,15198,2008,-4884802,-99.68983673469388,2000
4594,2008-01-18,Teeth,2000000,2350641,347578,2008,350641,17.532049999999998,2000
4896,2008-01-18,Taxi to the Dark Side,1000000,304472,274661,2008,-695528,-69.5528,2000
2878,2008-01-23,U2 3D,15000000,26170402,12898847,2008,11170402,74.46934666666667,2000
1140,2008-01-25,Rambo,47500000,112214531,42754105,2008,64714531,136.24111789473685,2000
1570,2008-01-25,Untraceable,35000000,52649951,28687835,2008,17649951,50.42843142857143,2000
1782,2008-01-25,Meet the Spartans,30000000,84646831,38233676,2008,54646831,182.15610333333333,2000
2701,2008-01-25,How She Move,17000000,8607815,7070641,2008,-8392185,-49.36579411764706,2000
4962,2008-01-25,"4 luni, 3 saptamani si 2 zile",900000,11993156,1196321,2008,11093156,1232.5728888888889,2000
66,2008-02-05,Iron Man,186000000,584604126,318604126,2008,398604126,214.3032935483871,2000
1344,2008-02-05,Made of Honor,40000000,106548738,46012734,2008,66548738,166.371845,2000
3754,2008-02-05,Redbelt,7000000,2667084,2344847,2008,-4332916,-61.8988,2000
4580,2008-02-05,Son of Rambow: A Home Movie,2000000,11263263,1785505,2008,9263263,463.16315000000003,2000
389,2008-02-14,The Spiderwick Chronicles,92500000,162839667,71195053,2008,70339667,76.04288324324324,2000
480,2008-02-14,Jumper,82500000,223636949,81168265,2008,141136949,171.07508969696968,2000
2658,2008-02-14,Step Up 2 the Streets,17500000,148586910,58017783,2008,131086910,749.0680571428571,2000
3717,2008-02-14,"Definitely, Maybe",7000000,55617866,32241649,2008,48617866,694.5409428571429,2000
3860,2008-02-15,Dolphins and Whales Tribes of the Ocean 3D,6000000,17252287,7714996,2008,11252287,187.53811666666667,2000
4448,2008-02-15,Diary of the Dead,2750000,5394447,952620,2008,2644447,96.16170909090908,2000
1312,2008-02-22,Vantage Point,40000000,150886329,72266306,2008,110886329,277.2158225,2000
2447,2008-02-22,Be Kind Rewind,20000000,30894247,11175164,2008,10894247,54.47123499999999,2000
3196,2008-02-22,Charlie Bartlett,12000000,5295909,3950294,2008,-6704091,-55.867425000000004,2000
3688,2008-02-22,Witless Protection,7500000,4151836,4151836,2008,-3348164,-44.64218666666667,2000
3824,2008-02-22,Die Fälscher,6250000,20199663,5488570,2008,13949663,223.19460800000002,2000
5332,2008-02-22,The Signal,50000,406299,251150,2008,356299,712.5980000000001,2000
952,2008-02-29,Semi-Pro,55000000,43980363,33479698,2008,-11019637,-20.035703636363635,2000
1380,2008-02-29,The Other Boleyn Girl,40000000,78269970,26814957,2008,38269970,95.674925,2000
3877,2008-03-07,The Wackness,6000000,3330012,2077046,2008,-2669988,-44.4998,2000
1926,2008-03-10,How to Lose Friends & Alienate People,28000000,12031443,2775593,2008,-15968557,-57.03056071428571,2000
2140,2008-03-10,Blindness,25000000,20052958,3073392,2008,-4947042,-19.788168,2000
2319,2008-03-10,Beverly Hills Chihuahua,20000000,154218168,94514402,2008,134218168,671.09084,2000
2468,2008-03-10,An American Carol,20000000,7022183,7013191,2008,-12977817,-64.88908500000001,2000
2482,2008-03-10,Flash of Genius,20000000,4504111,4442377,2008,-15495889,-77.479445,2000
3176,2008-03-10,Rachel Getting Married,12000000,17475475,12796861,2008,5475475,45.62895833333334,2000
3335,2008-03-10,Nick and Norah's Infinite Playlist,10000000,33886017,31487293,2008,23886017,238.86017,2000
445,2008-03-14,Horton Hears a Who,85000000,299477886,154529439,2008,214477886,252.32692470588236,2000
1652,2008-03-14,Doomsday,33000000,21621188,11008770,2008,-11378812,-34.481248484848486,2000
2293,2008-03-14,Never Back Down,21000000,39319801,24850922,2008,18319801,87.23714761904762,2000
2922,2008-03-14,Funny Games,15000000,8200127,1294640,2008,-6799873,-45.33248666666667,2000
4685,2008-03-19,La misma luna,1700000,23271741,12590147,2008,21571741,1268.9259411764706,2000
1366,2008-03-21,Drillbit Taylor,40000000,49686263,32862104,2008,9686263,24.215657500000002,2000
2349,2008-03-21,Meet the Browns,20000000,41975388,41975388,2008,21975388,109.87693999999999,2000
3611,2008-03-21,Shutter,8000000,47782426,25928550,2008,39782426,497.280325,2000
4406,2008-03-21,The Grand,3000000,115879,115879,2008,-2884121,-96.13736666666667,2000
4972,2008-03-21,The Hammer,850000,442638,442638,2008,-407362,-47.92494117647059,2000
1522,2008-03-28,21,35000000,159846429,81159365,2008,124846429,356.7040828571429,2000
1574,2008-03-28,Superhero Movie,35000000,73026302,26638520,2008,38026302,108.64657714285715,2000
2123,2008-03-28,Stop-Loss,25000000,11229035,10915744,2008,-13770965,-55.083859999999994,2000
3408,2008-03-28,"Run, Fatboy, Run",10000000,33512260,6003262,2008,23512260,235.1226,2000
5198,2008-03-28,Happy Valley,250000,67665,67665,2008,-182335,-72.934,2000
2384,2008-04-01,One Missed Call,20000000,44513466,26890041,2008,24513466,122.56733,2000
890,2008-04-04,Leatherheads,58000000,41348628,31373938,2008,-16651372,-28.70926206896552,2000
1482,2008-04-04,Nim's Island,37000000,101857425,48006762,2008,64857425,175.29033783783782,2000
2097,2008-04-04,The Ruins,25000000,22910563,17432844,2008,-2089437,-8.357747999999999,2000
3442,2008-04-04,My Blueberry Nights,10000000,22198996,866778,2008,12198996,121.98996,2000
4860,2008-04-04,Shine a Light,1000000,16173879,5505267,2008,15173879,1517.3879,2000
280,2008-04-07,Astérix aux Jeux Olympiques,113500000,132999811,999811,2008,19499811,17.18045022026432,2000
2562,2008-04-07,Ne le dis à personne,18500000,33954018,6198883,2008,15454018,83.53523243243242,2000
4416,2008-04-15,à L'Intérieur,3000000,895932,0,2008,-2104068,-70.1356,2000
939,2008-04-18,The Forbidden Kingdom,55000000,129075270,52075270,2008,74075270,134.6823090909091,2000
1742,2008-04-18,Forgetting Sarah Marshall,30000000,105173042,63172463,2008,75173042,250.57680666666667,2000
1820,2008-04-18,88 Minutes,30000000,32955399,16930884,2008,2955399,9.851329999999999,2000
3213,2008-04-18,Life Before Her Eyes,12000000,7203439,303439,2008,-4796561,-39.97134166666667,2000
3657,2008-04-18,Pathology,8000000,3270974,109045,2008,-4729026,-59.112825,2000
5076,2008-04-18,Kiss the Bride,500000,32033,32033,2008,-467967,-93.5934,2000
1745,2008-04-25,Baby Mama,30000000,64170447,60494212,2008,34170447,113.90149000000001,2000
2137,2008-04-25,Deception,25000000,12850033,4598506,2008,-12149967,-48.599868,2000
2224,2008-04-25,Rogue,23000000,4673377,10452,2008,-18326623,-79.6809695652174,2000
3141,2008-04-25,Harold & Kumar Escape from Guantanamo Bay,12000000,43353117,38108728,2008,31353117,261.275975,2000
4060,2008-04-25,Standard Operating Procedure,5000000,332120,228830,2008,-4667880,-93.35759999999999,2000
1218,2008-05-09,Bangkok Dangerous,45000000,46598133,15298133,2008,1598133,3.5514066666666664,2000
3894,2008-05-09,"Surfer, Dude",6000000,36497,36497,2008,-5963503,-99.39171666666667,2000
1612,2008-05-12,Punisher: War Zone,35000000,10157534,8050977,2008,-24842466,-70.97847428571428,2000
1872,2008-05-12,Frost/Nixon,29000000,28452945,18622031,2008,-547055,-1.886396551724138,2000
3183,2008-05-12,Cadillac Records,12000000,8942516,8195551,2008,-3057484,-25.479033333333334,2000
25,2008-05-16,The Chronicles of Narnia: Prince Caspian,225000000,417341288,141621490,2008,192341288,85.4850168888889,2000
68,2008-05-22,Indiana Jones and the Kingdom of the Crystal Skull,185000000,786558145,317023851,2008,601558145,325.1665648648649,2000
2496,2008-05-23,The Children of Huang Shi,20000000,8221700,1031872,2008,-11778300,-58.89149999999999,2000
3446,2008-05-23,"War, Inc.",10000000,1299855,580862,2008,-8700145,-87.00145,2000
4111,2008-05-28,Savage Grace,4600000,968805,434417,2008,-3631195,-78.93902173913044,2000
894,2008-05-30,Sex and the City,57500000,415247258,152647258,2008,357747258,622.1691443478261,2000
3515,2008-05-30,The Strangers,9000000,83051676,52597610,2008,74051676,822.7964,2000
4067,2008-05-30,Stuck,5000000,67505,67505,2008,-4932495,-98.6499,2000
214,2008-06-06,Kung Fu Panda,130000000,631910531,215434591,2008,501910531,386.0850238461539,2000
408,2008-06-06,You Don't Mess With the Zohan,90000000,202910991,100018837,2008,112910991,125.45665666666667,2000
2627,2008-06-06,Mongol,18000000,27147349,5705761,2008,9147349,50.81860555555555,2000
3645,2008-06-06,And When Did You Last See Your Father?,8000000,2476491,1071240,2008,-5523509,-69.0438625,2000
1943,2008-06-08,The Sisterhood of the Traveling Pants 2,27000000,44270131,44089964,2008,17270131,63.96344814814815,2000
1971,2008-06-08,The Pineapple Express,26000000,102404019,87341380,2008,76404019,293.86161153846155,2000
4039,2008-06-08,Bottle Shock,5000000,4815890,4078607,2008,-184110,-3.6822,2000
196,2008-06-13,The Incredible Hulk,137500000,263417913,134806913,2008,125917913,91.576664,2000
810,2008-06-13,The Happening,60000000,162778384,64506874,2008,102778384,171.29730666666666,2000
5242,2008-06-13,Baghead,200000,140016,140016,2008,-59984,-29.992,2000
498,2008-06-20,Get Smart,80000000,226739416,130319208,2008,146739416,183.42426999999998,2000
766,2008-06-20,The Love Guru,62000000,40123346,32200122,2008,-21876654,-35.28492580645161,2000
3364,2008-06-20,Kit Kittredge: An American Girl,10000000,17657973,17657973,2008,7657973,76.57973,2000
4487,2008-06-20,Brick Lane,2500000,3838486,1094998,2008,1338486,53.539440000000006,2000
75,2008-06-27,WALL-E,180000000,532590994,223808164,2008,352590994,195.88388555555557,2000
582,2008-06-27,Wanted,75000000,342416460,134508551,2008,267416460,356.55528,2000
315,2008-07-03,"10,000 B.C.",105000000,269065678,94784201,2008,164065678,156.25302666666667,2000
2379,2008-07-03,The Bank Job,20000000,66143005,30060660,2008,46143005,230.715025,2000
2505,2008-07-03,長江七號 (CJ7),20000000,47300771,206678,2008,27300771,136.503855,2000
3205,2008-07-03,Married Life,12000000,2975188,1506998,2008,-9024812,-75.20676666666667,2000
4731,2008-07-03,Snow Angels,1500000,414404,402858,2008,-1085596,-72.37306666666666,2000
149,2008-07-11,Madagascar: Escape 2 Africa,150000000,599516844,180010950,2008,449516844,299.677896,2000
1408,2008-07-11,Soul Men,40000000,12345883,12082391,2008,-27654117,-69.1352925,2000
1889,2008-07-11,Role Models,28000000,94500826,67300955,2008,66500826,237.50295,2000
3104,2008-07-11,The Boy in the Striped Pajamas,12500000,44083403,9046156,2008,31583403,252.66722399999998,2000
3585,2008-07-11,Repo! The Genetic Opera,8500000,198883,140244,2008,-8301117,-97.6602,2000
67,2008-07-18,The Dark Knight,185000000,1002572859,533345358,2008,817572859,441.93127513513514,2000
988,2008-07-18,Mamma Mia!,52000000,615748877,144130063,2008,563748877,1084.1324557692308,2000
1486,2008-07-18,Space Chimps,37000000,67029956,30105968,2008,30029956,81.16204324324325,2000
2919,2008-07-18,Transsiberian,15000000,6379575,2203641,2008,-8620425,-57.4695,2000
5348,2008-07-18,The Legend of God's Gun,30000,243768,243768,2008,213768,712.5600000000001,2000
719,2008-07-25,Step Brothers,65000000,128468793,100468793,2008,63468793,97.64429692307692,2000
1585,2008-07-25,The X-Files: I Want to Believe,35000000,68170792,20982478,2008,33170792,94.77369142857142,2000
2771,2008-07-25,Bienvenue chez les Ch'tis,16000000,247474497,1477650,2008,231474497,1446.71560625,2000
4650,2008-07-25,Man on Wire,1900000,5617067,2962242,2008,3717067,195.6351052631579,2000
3477,2008-08-01,White Noise 2: The Light,10000000,8243567,0,2008,-1756433,-17.56433,2000
623,2008-08-02,Fool's Gold,72500000,109362966,70231041,2008,36862966,50.84547034482758,2000
1931,2008-08-02,Welcome Home Roscoe Jenkins,27500000,43607627,42436517,2008,16107627,58.573189090909096,2000
2902,2008-08-02,In Bruges,15000000,34533783,7800825,2008,19533783,130.22522,2000
2628,2008-08-10,RocknRolla,18000000,27794339,5700626,2008,9794339,54.41299444444444,2000
405,2008-08-13,Tropic Thunder,90000000,191091250,110461307,2008,101091250,112.3236111111111,2000
5380,2008-08-14,The Rise and Fall of Miss Thang,10000,401,401,2008,-9599,-95.99,2000
1567,2008-08-15,Mirrors,35000000,77220596,30691439,2008,42220596,120.6302742857143,2000
2109,2008-08-15,Fly Me To the Moon,25000000,43530281,14543943,2008,18530281,74.12112400000001,2000
2744,2008-08-15,Vicky Cristina Barcelona,16000000,104504817,23216709,2008,88504817,553.15510625,2000
3569,2008-08-15,Star Wars: The Clone Wars,8500000,68695443,35161554,2008,60195443,708.1816823529412,2000
2905,2008-08-20,The Rocker,15000000,8767338,6409528,2008,-6232662,-41.55108,2000
741,2008-08-22,Death Race,65000000,72516819,36316032,2008,7516819,11.564336923076922,2000
2043,2008-08-22,The House Bunny,25000000,71390601,48237389,2008,46390601,185.562404,2000
2217,2008-08-22,The Longshots,23000000,11778396,11511323,2008,-11221604,-48.78958260869565,2000
3536,2008-08-22,Hamlet 2,9000000,4934104,4886216,2008,-4065896,-45.17662222222222,2000
1472,2008-08-26,Virgin Territory,38000000,5473041,0,2008,-32526959,-85.5972605263158,2000
2251,2008-08-27,Traitor,22000000,27882226,23530831,2008,5882226,26.73739090909091,2000
1208,2008-08-29,Babylon A.D.,45000000,70216497,22532572,2008,25216497,56.036660000000005,2000
2430,2008-08-29,Disaster Movie,20000000,36720752,14190901,2008,16720752,83.60376000000001,2000
3866,2008-08-29,College,6000000,6176114,4694491,2008,176114,2.9352333333333336,2000
4092,2008-08-29,Obsluhoval jsem anglického krále,4900000,7174984,617228,2008,2274984,46.42824489795918,2000
268,2008-09-05,Speed Racer,120000000,93394462,43945766,2008,-26605538,-22.17128166666667,2000
1523,2008-09-05,What Happens in Vegas...,35000000,218535708,80277646,2008,183535708,524.3877371428572,2000
5116,2008-09-05,Poultrygeist: Night of the Chicken Dead,450000,22623,13804,2008,-427377,-94.97266666666667,2000
1952,2008-09-19,The Duchess,27000000,45160110,13848978,2008,18160110,67.25966666666666,2000
2256,2008-09-19,Igor,22000000,31013349,19528602,2008,9013349,40.96976818181818,2000
2352,2008-09-19,Lakeview Terrace,20000000,44821299,39263506,2008,24821299,124.106495,2000
2403,2008-09-19,Appaloosa,20000000,27911453,20211394,2008,7911453,39.557265,2000
2407,2008-09-19,My Best Friend's Girl,20000000,34787111,19219250,2008,14787111,73.935555,2000
2438,2008-09-19,Ghost Town,20000000,29843245,13252641,2008,9843245,49.216225,2000
3799,2008-09-19,Tropa de Elite,6537890,14319195,8744,2008,7781305,119.01859774330863,2000
508,2008-09-26,Eagle Eye,80000000,178066569,101440743,2008,98066569,122.58321125,2000
1224,2008-09-26,Miracle at St. Anna,45000000,9676497,7916887,2008,-35323503,-78.49667333333333,2000
3012,2008-09-26,The Lucky Ones,14000000,266967,266967,2008,-13733033,-98.09309285714286,2000
4306,2008-09-26,Choke,3400000,4124277,2926565,2008,724277,21.302264705882354,2000
5048,2008-09-26,Fireproof,500000,33473297,33456317,2008,32973297,6594.6594000000005,2000
699,2008-10-10,Body of Lies,67500000,118556530,39394666,2008,51056530,75.6393037037037,2000
1469,2008-10-10,City of Ember,38000000,17830244,7871693,2008,-20169756,-53.0783052631579,2000
1475,2008-10-10,The Express,37500000,9813309,9793406,2008,-27686691,-73.831176,2000
3146,2008-10-10,Quarantine,12000000,41924774,31691811,2008,29924774,249.37311666666665,2000
5239,2008-10-10,Call+Response,200000,212989,212989,2008,12989,6.4945,2000
5245,2008-10-10,Good Dick,200000,52443,28835,2008,-147557,-73.77850000000001,2000
1659,2008-10-12,The Reader,32500000,112964875,34194407,2008,80464875,247.58423076923077,2000
5161,2008-10-12,Wendy and Lucy,300000,1416046,865695,2008,1116046,372.01533333333333,2000
1549,2008-10-17,Max Payne,35000000,85761789,40687294,2008,50761789,145.03368285714288,2000
1962,2008-10-17,What Just Happened,27000000,2412123,1090947,2008,-24587877,-91.0662111111111,2000
2005,2008-10-17,W.,25100000,28575778,25534493,2008,3475778,13.847721115537848,2000
2548,2008-10-17,Sex Drive,19000000,10412485,8402485,2008,-8587515,-45.19744736842105,2000
3254,2008-10-17,The Secret Life of Bees,11000000,39984023,37770162,2008,28984023,263.49111818181814,2000
947,2008-10-24,Changeling,55000000,113805580,35739802,2008,58805580,106.91923636363636,2000
1823,2008-10-24,Pride and Glory,30000000,43440721,15740721,2008,13440721,44.80240333333334,2000
2481,2008-10-24,Passchendaele,20000000,4453327,4452423,2008,-15546673,-77.73336499999999,2000
2486,2008-10-24,"Synecdoche, New York",20000000,4383538,3083538,2008,-15616462,-78.08230999999999,2000
3243,2008-10-24,High School Musical 3: Senior Year,11000000,274392880,90559416,2008,263392880,2394.4807272727276,2000
3286,2008-10-24,Saw V,10800000,118209778,56746769,2008,107409778,994.5349814814815,2000
4123,2008-10-24,Låt den rätte komma in,4500000,12247682,2122085,2008,7747682,172.1707111111111,2000
4604,2008-10-24,Roadside Romeo,2000000,2046090,55202,2008,46090,2.3045,2000
5128,2008-10-24,Heroes,400000,655538,655538,2008,255538,63.8845,2000
2178,2008-10-31,Zack and Miri Make a Porno,24000000,36856306,31457946,2008,12856306,53.56794166666666,2000
4007,2008-10-31,The Haunting of Molly Hartley,5000000,15318257,13442412,2008,10318257,206.36514,2000
4494,2008-10-31,The Other End of the Line,2500000,507446,115504,2008,-1992554,-79.70216,2000
4615,2008-10-31,Eden Lake,2000000,4294373,7321,2008,2294373,114.71865000000001,2000
4737,2008-10-31,My Name is Bruce,1500000,173066,173066,2008,-1326934,-88.46226666666666,2000
5223,2008-10-31,Little Big Top,240000,7484,7484,2008,-232516,-96.88166666666666,2000
876,2008-11-01,In the Name of the King: A Dungeon Siege Tale,60000000,13233220,4775656,2008,-46766780,-77.94463333333333,2000
2877,2008-11-01,The Pirates Who Don't Do Anything: A VeggieTales Movie,15000000,13248444,12981269,2008,-1751556,-11.67704,2000
2386,2008-11-04,Street Kings,20000000,65454793,26415649,2008,45454793,227.273965,2000
2582,2008-11-04,Prom Night,18000000,57193655,43869350,2008,39193655,217.74252777777775,2000
4187,2008-11-04,The Visitor,4000000,19174817,9427026,2008,15174817,379.37042499999995,2000
481,2008-11-07,Hellboy II: The Golden Army,82500000,160388063,75986503,2008,77888063,94.40977333333333,2000
872,2008-11-07,Meet Dave,60000000,50648806,11803254,2008,-9351194,-15.585323333333335,2000
1165,2008-11-07,Journey to the Center of the Earth,45000000,243180937,101704370,2008,198180937,440.4020822222222,2000
4308,2008-11-07,August,3400000,12636,12636,2008,-3387364,-99.62835294117647,2000
21,2008-11-14,Quantum of Solace,230000000,591692078,169368427,2008,361692078,157.2574252173913,2000
4492,2008-11-14,Fuel,2500000,174255,174255,2008,-2325745,-93.0298,2000
161,2008-11-21,Bolt,150000000,328015209,114053759,2008,178015209,118.67680599999998,2000
1476,2008-11-21,Twilight,37000000,402280159,192769854,2008,365280159,987.243672972973,2000
4917,2008-11-21,Special,1000000,26822,7202,2008,-973178,-97.3178,2000
225,2008-11-26,Australia,130000000,215080810,49554002,2008,85080810,65.44677692307692,2000
502,2008-11-26,Four Christmases,80000000,168311558,120146040,2008,88311558,110.38944749999999,2000
2374,2008-11-26,Milk,20000000,57293371,31841299,2008,37293371,186.466855,2000
841,2008-12-09,Righteous Kill,60000000,78481410,40081410,2008,18481410,30.80235,2000
1481,2008-12-09,Burn After Reading,37000000,168167798,60355347,2008,131167798,354.5075621621622,2000
2742,2008-12-09,The Women,16000000,50103808,26902075,2008,34103808,213.1488,2000
2960,2008-12-11,Slumdog Millionaire,14000000,384519665,141319928,2008,370519665,2646.5690357142857,2000
519,2008-12-12,The Day the Earth Stood Still,80000000,233066978,79366978,2008,153066978,191.3337225,2000
893,2008-12-12,"Che, El Ar the Argentine",58000000,30118557,293708,2008,-27881443,-48.07145344827586,2000
1425,2008-12-12,Delgo,40000000,915840,915840,2008,-39084160,-97.71039999999999,2000
2011,2008-12-12,Gran Torino,25000000,274543085,148095302,2008,249543085,998.17234,2000
2369,2008-12-12,Doubt,20000000,53191101,33446470,2008,33191101,165.95550500000002,2000
4463,2008-12-12,Los Cronocrímenes,2600000,564474,39127,2008,-2035526,-78.28946153846154,2000
3838,2008-12-17,The Wrestler,6000000,46634275,26238243,2008,40634275,677.2379166666667,2000
824,2008-12-19,The Tale of Despereaux,60000000,90482317,50877145,2008,30482317,50.80386166666667,2000
972,2008-12-19,Seven Pounds,54000000,166617328,69951824,2008,112617328,208.5506074074074,2000
1018,2008-12-19,Yes Man,50000000,225990976,97690976,2008,175990976,351.981952,2000
122,2008-12-25,The Curious Case of Benjamin Button,160000000,329809326,127509326,2008,169809326,106.13082874999999,2000
413,2008-12-25,Valkyrie,90000000,203902107,83077762,2008,113902107,126.55789666666666,2000
504,2008-12-25,Bedtime Stories,80000000,221468935,110101975,2008,141468935,176.83616874999998,2000
777,2008-12-25,Marley & Me,60000000,247812011,143153751,2008,187812011,313.0200183333333,2000
865,2008-12-25,The Spirit,60000000,39006188,19806188,2008,-20993812,-34.989686666666664,2000
4577,2008-12-25,Waltz with Bashir,2000000,13912289,2283849,2008,11912289,595.6144499999999,2000
1207,2008-12-26,Revolutionary Road,45000000,79564960,22911480,2008,34564960,76.81102222222222,2000
2510,2008-12-31,Koltchak,20000000,38585047,0,2008,18585047,92.925235,2000
2648,2008-12-31,I Come with the Rain,18000000,627422,0,2008,-17372578,-96.51432222222223,2000
2774,2008-12-31,Good,16000000,31631,31631,2008,-15968369,-99.80230625,2000
2943,2008-12-31,Bathory,15000000,3436763,0,2008,-11563237,-77.08824666666668,2000
3018,2008-12-31,Ca$h,13700000,11738256,0,2008,-1961744,-14.319299270072994,2000
4075,2008-12-31,The Cottage,5000000,1504960,0,2008,-3495040,-69.90079999999999,2000
4453,2008-12-31,Rejsen til Saturn,2700000,5377665,0,2008,2677665,99.17277777777778,2000
4813,2008-12-31,Extreme Movie,1200000,81338,0,2008,-1118662,-93.22183333333334,2000
150,2009-01-05,X-Men Origins: Wolverine,150000000,374825760,179883157,2009,224825760,149.88384,2000
322,2009-01-07,Public Enemies,102500000,212282709,97104620,2009,109782709,107.1050819512195,2000
399,2009-01-07,Ice Age: Dawn of the Dinosaurs,90000000,859701857,196573705,2009,769701857,855.2242855555555,2000
1079,2009-01-16,Defiance,50000000,52987754,28644813,2009,2987754,5.9755080000000005,2000
1526,2009-01-16,Hotel for Dogs,35000000,122213085,73034460,2009,87213085,249.18024285714284,2000
1966,2009-01-16,Paul Blart: Mall Cop,26000000,185904750,146336178,2009,159904750,615.0182692307692,2000
2540,2009-01-16,Notorious,19000000,45005151,36843682,2009,26005151,136.86921578947369,2000
2966,2009-01-16,My Bloody Valentine,14000000,102836002,51545952,2009,88836002,634.5428714285714,2000
867,2009-01-23,Inkheart,60000000,66655938,17303424,2009,6655938,11.09323,2000
1116,2009-01-23,Outlander,50000000,1250617,166003,2009,-48749383,-97.498766,2000
1545,2009-01-23,Underworld 3: Rise of the Lycans,35000000,89102315,45802315,2009,54102315,154.57804285714286,2000
5003,2009-01-23,Donkey Punch,750000,814801,19367,2009,64801,8.640133333333333,2000
2012,2009-01-30,Taken,25000000,226941585,145000989,2009,201941585,807.76634,2000
3622,2009-01-30,New in Town,8000000,29937909,16734283,2009,21937909,274.2238625,2000
4319,2009-01-30,Entre les murs,3250000,34114067,3766810,2009,30864067,949.6636000000001,2000
2195,2009-02-10,Zombieland,23600000,102236596,75590286,2009,78636596,333.2059152542373,2000
2560,2009-02-10,The Invention of Lying,18500000,32679264,18451251,2009,14179264,76.64467027027027,2000
2876,2009-02-10,Whip It,15000000,18856151,13043363,2009,3856151,25.707673333333332,2000
3739,2009-02-10,A Serious Man,7000000,30360570,9228788,2009,23360570,333.72242857142857,2000
1087,2009-02-13,The International,50000000,53850527,25450527,2009,3850527,7.701054,2000
2673,2009-02-13,Friday the 13th,17000000,92670237,65002019,2009,75670237,445.11904117647066,2000
3197,2009-02-13,Two Lovers,12000000,16349034,3149034,2009,4349034,36.24195,2000
3826,2009-02-13,Gomorra,6200000,37339594,1579146,2009,31139594,502.25151612903227,2000
2417,2009-02-20,Fired Up,20000000,18608570,17231291,2009,-1391430,-6.9571499999999995,2000
2657,2009-02-20,Madea Goes To Jail,17500000,90508336,90508336,2009,73008336,417.1904914285714,2000
1110,2009-02-27,Street Fighter: The Legend of Chun-Li,50000000,12335036,9135036,2009,-37664964,-75.329928,2000
5081,2009-02-27,Scott Walker: 30 Century Man,500000,77121,6840,2009,-422879,-84.5758,2000
444,2009-03-04,Fast & Furious,85000000,363064265,155064265,2009,278064265,327.1344294117647,2000
3492,2009-03-04,Adventureland,9800000,17553055,16044025,2009,7753055,79.11280612244897,2000
1035,2009-03-13,Race to Witch Mountain,50000000,105103783,67172594,2009,55103783,110.20756599999999,2000
2836,2009-03-13,The Last House on the Left,15000000,46526243,32752215,2009,31526243,210.17495333333335,2000
3869,2009-03-13,Miss March,6000000,4713059,4543320,2009,-1286941,-21.44901666666667,2000
4013,2009-03-13,Sunshine Cleaning,5000000,17329337,12062558,2009,12329337,246.58674,2000
840,2009-03-20,Duplicity,60000000,81079566,40572825,2009,21079566,35.13261,2000
1027,2009-03-20,Knowing,50000000,186450317,79957634,2009,136450317,272.900634,2000
1313,2009-03-20,"I Love You, Man",40000000,91729503,71440011,2009,51729503,129.3237575,2000
4609,2009-03-20,Super Capers,2000000,30955,30955,2009,-1969045,-98.45224999999999,2000
88,2009-03-27,Monsters vs. Aliens,175000000,381687380,198351526,2009,206687380,118.10707428571428,2000
2444,2009-03-27,12 Rounds,20000000,17306648,12234694,2009,-2693352,-13.46676,2000
1096,2009-04-09,Gamer,50000000,42002029,20534907,2009,-7997971,-15.995942,2000
2833,2009-04-09,All About Steve,15000000,40127259,33862903,2009,25127259,167.51506,2000
3683,2009-04-09,Extract,7500000,10849158,10823158,2009,3349158,44.65544,2000
1727,2009-04-12,Up in the Air,30000000,166842739,83823381,2009,136842739,456.1424633333333,2000
1987,2009-04-12,Brothers,26000000,45043870,28544157,2009,19043870,73.24565384615384,2000
2421,2009-04-12,Armored,20000000,23661038,15988876,2009,3661038,18.30519,2000
2455,2009-04-12,Everybody's Fine,20000000,9208876,9208876,2009,-10791124,-53.95562,2000
4152,2009-04-12,Paa,4300000,9791282,199228,2009,5491282,127.70423255813954,2000
843,2009-04-17,State of Play,60000000,88832210,37017955,2009,28832210,48.05368333333334,2000
1320,2009-04-17,17 Again,40000000,139474906,64167069,2009,99474906,248.687265,2000
2433,2009-04-17,Crank 2: High Voltage,20000000,35472739,13684249,2009,15472739,77.36369499999999,2000
4496,2009-04-17,Sleep Dealer,2500000,108907,80136,2009,-2391093,-95.64372,2000
1145,2009-04-22,Earth,47000000,116773317,32011576,2009,69773317,148.4538659574468,2000
5078,2009-04-23,Home,500000,44793168,15433,2009,44293168,8858.633600000001,2000
852,2009-04-24,The Soloist,60000000,38389024,31720158,2009,-21610976,-36.01829333333333,2000
2329,2009-04-24,Obsessed,20000000,73964713,68261644,2009,53964713,269.823565,2000
2644,2009-04-24,The Informers,18000000,315000,315000,2009,-17685000,-98.25,2000
354,2009-05-06,Land of the Lost,100000000,69548641,49438370,2009,-30451359,-30.451359,2000
1508,2009-05-06,The Hangover,35000000,465764086,277322503,2009,430764086,1230.7545314285715,2000
2298,2009-05-06,Away We Go,21000000,10108016,9451946,2009,-10891984,-51.866590476190474,2000
2699,2009-05-06,My Life in Ruins,17000000,20465206,8665206,2009,3465206,20.383564705882353,2000
3226,2009-05-06,Home,12000000,1620056,0,2009,-10379944,-86.49953333333333,2000
156,2009-05-15,Angels & Demons,150000000,490875846,133375846,2009,340875846,227.250564,2000
2485,2009-05-15,The Brothers Bloom,20000000,5531756,3531756,2009,-14468244,-72.34121999999999,2000
53,2009-05-21,Terminator Salvation,200000000,365491792,125322469,2009,165491792,82.745896,2000
151,2009-05-22,Night at the Museum: Battle of the Smithsonian,150000000,402231063,177243721,2009,252231063,168.154042,2000
2081,2009-05-22,Dance Flick,25000000,32092761,25662155,2009,7092761,28.371044,2000
3006,2009-05-22,Easy Virtue,14000000,20537741,2656784,2009,6537741,46.69815,2000
4771,2009-05-22,The Girlfriend Experience,1300000,1005840,695840,2009,-294160,-22.627692307692307,2000
86,2009-05-29,Up,175000000,731542621,293004164,2009,556542621,318.02435485714284,2000
1772,2009-05-29,Drag Me To Hell,30000000,91388487,42100625,2009,61388487,204.62829,2000
3067,2009-05-29,Män som hatar kvinnor,13000000,109421911,12749992,2009,96421911,741.7070076923077,2000
4744,2009-05-29,Pontypool,1500000,31916,3865,2009,-1468084,-97.87226666666666,2000
805,2009-06-02,Coraline,60000000,126037057,75286229,2009,66037057,110.06176166666665,2000
1294,2009-06-02,He's Just Not That Into You,40000000,181053657,93953653,2009,141053657,352.6341425,2000
1460,2009-06-02,Push,38000000,44411527,31811527,2009,6411527,16.87243947368421,2000
3879,2009-06-02,Polytechnique,6000000,1418304,1418304,2009,-4581696,-76.3616,2000
194,2009-06-03,Watchmen,138000000,184068357,107509799,2009,46068357,33.38286739130435,2000
63,2009-06-11,Disney's A Christmas Carol,190000000,315709697,137855863,2009,125709697,66.16299842105263,2000
2105,2009-06-11,The Box,25000000,26341896,15051977,2009,1341896,5.367584,2000
2177,2009-06-11,The Men Who Stare at Goats,24000000,67348218,32428195,2009,43348218,180.617575,2000
3317,2009-06-11,Precious (Based on the Novel Push by Sapphire),10000000,68722848,47566524,2009,58722848,587.22848,2000
3349,2009-06-11,The Fourth Kind,10000000,49486874,26218170,2009,39486874,394.86874,2000
835,2009-06-19,Year One,60000000,57604723,43337279,2009,-2395277,-3.9921283333333335,2000
1280,2009-06-19,The Proposal,40000000,314709717,163958031,2009,274709717,686.7742925,2000
2907,2009-06-19,Whatever Works,15000000,35106706,5306706,2009,20106706,134.04470666666666,2000
4989,2009-06-19,Dod sno,800000,2194020,46742,2009,1394020,174.2525,2000
2712,2009-06-23,Chasseurs de dragons,17000000,13446115,0,2009,-3553885,-20.90520588235294,2000
30,2009-06-24,Transformers: Revenge of the Fallen,210000000,836519699,402111870,2009,626519699,298.34271380952384,2000
1930,2009-06-26,My Sister's Keeper,27500000,96673002,49200230,2009,69173002,251.5381890909091,2000
2222,2009-06-26,Chéri,23000000,2715657,2715657,2009,-20284343,-88.19279565217391,2000
2868,2009-06-26,The Hurt Locker,15000000,49894223,17017811,2009,34894223,232.62815333333333,2000
4292,2009-06-26,Surveillance,3500000,1396395,27349,2009,-2103605,-60.102999999999994,2000
3224,2009-07-04,1612,12000000,5400624,0,2009,-6599376,-54.9948,2000
4074,2009-07-07,Flying By,5000000,4568257,0,2009,-431743,-8.63486,2000
89,2009-07-08,G.I. Joe: The Rise of Cobra,175000000,302469017,150201498,2009,127469017,72.83943828571428,2000
1293,2009-07-08,Julie & Julia,40000000,126646119,94125426,2009,86646119,216.61529750000003,2000
2985,2009-07-08,A Perfect Getaway,14000000,22815460,15515460,2009,8815460,62.96757142857143,2000
3220,2009-07-11,Nanjing! Nanjing!,12000000,20122558,122558,2009,8122558,67.68798333333334,2000
4537,2009-07-14,[Rec],2100000,23266821,0,2009,21166821,1007.9438571428572,2000
14,2009-07-15,Harry Potter and the Half-Blood Prince,250000000,935083686,301959197,2009,685083686,274.0334744,2000
160,2009-07-24,G-Force,150000000,292817841,119436770,2009,142817841,95.211894,2000
1446,2009-07-24,The Ugly Truth,38000000,205298907,88915214,2009,167298907,440.2602815789474,2000
2350,2009-07-24,Orphan,20000000,78769428,41596251,2009,58769428,293.84714,2000
4325,2009-07-29,Adam,3200000,2828590,2277396,2009,-371410,-11.6065625,2000
624,2009-07-31,Funny People,72500000,71880305,51855045,2009,-619695,-0.854751724137931,2000
1205,2009-07-31,Aliens in the Attic,45000000,59551283,25200412,2009,14551283,32.33618444444444,2000
3553,2009-07-31,Flammen og Citronen,9000000,1635241,148089,2009,-7364759,-81.83065555555555,2000
4365,2009-07-31,The Collector,3000000,10473836,7712114,2009,7473836,249.12786666666668,2000
181,2009-08-05,Star Trek,140000000,385680446,257730019,2009,245680446,175.48603285714285,2000
3892,2009-08-05,Julia,6000000,1365108,65108,2009,-4634892,-77.2482,2000
4217,2009-08-05,Adoration,4000000,384244,294244,2009,-3615756,-90.3939,2000
4358,2009-08-05,Next Day Air,3000000,10172519,10027047,2009,7172519,239.08396666666664,2000
1436,2009-08-14,The Time Traveler's Wife,39000000,102332135,63414846,2009,63332135,162.39008974358975,2000
1637,2009-08-14,Gake no ue no Ponyo,34000000,205312666,15090399,2009,171312666,503.86078235294116,2000
1714,2009-08-14,District 9,30000000,212453431,115646235,2009,182453431,608.1781033333334,2000
2477,2009-08-14,Bandslam,20000000,12967829,5210988,2009,-7032171,-35.160855000000005,2000
3376,2009-08-14,"The Goods: Live Hard, Sell Hard",10000000,15297318,15122676,2009,5297318,52.97318,2000
4071,2009-08-14,Grace,5000000,8297,8297,2009,-4991703,-99.83406000000001,2000
642,2009-08-21,Inglourious Basterds,70000000,316915264,120774594,2009,246915264,352.7360914285714,2000
2401,2009-08-21,Shorts,20000000,29870801,20919166,2009,9870801,49.354005,2000
2522,2009-08-21,Der Baader Meinhof Komplex,19700000,16498827,476270,2009,-3201173,-16.249609137055838,2000
2906,2009-08-21,Post Grad,15000000,6561243,6380019,2009,-8438757,-56.258379999999995,2000
3454,2009-08-21,World's Greatest Dad,10000000,295750,221805,2009,-9704250,-97.0425,2000
3480,2009-08-21,Fifty Dead Men Walking,10000000,997921,0,2009,-9002079,-90.02078999999999,2000
1876,2009-08-26,Taking Woodstock,29000000,10066366,7460204,2009,-18933634,-65.28839310344827,2000
1319,2009-08-28,The Final Destination,40000000,187384627,66477700,2009,147384627,368.4615675,2000
2835,2009-08-28,Halloween 2,15000000,38512850,33392973,2009,23512850,156.75233333333333,2000
3469,2009-08-28,The Open Road,10000000,19716,19716,2009,-9980284,-99.80284,2000
1747,2009-09-01,Bride Wars,30000000,115150424,58715510,2009,85150424,283.83474666666666,2000
1878,2009-09-01,"Che, Part 1: The Argentine",29000000,1733532,1733532,2009,-27266468,-94.02230344827586,2000
2732,2009-09-01,The Unborn,16000000,78208812,42670410,2009,62208812,388.805075,2000
4018,2009-09-01,Not Easily Broken,5000000,10732909,10572742,2009,5732909,114.65818000000002,2000
1793,2009-09-09,9,30000000,48559999,31749894,2009,18559999,61.866663333333335,2000
783,2009-09-10,Couples Retreat,60000000,172450423,109205660,2009,112450423,187.41737166666667,2000
3238,2009-09-10,St. Trinian’s,11400000,29830239,15000,2009,18430239,161.66876315789474,2000
3458,2009-09-10,Free Style,10000000,721108,141108,2009,-9278892,-92.78891999999999,2000
3682,2009-09-10,An Education,7500000,29652736,12574914,2009,22152736,295.36981333333335,2000
3823,2009-09-10,The Damned United,6400000,4199874,449865,2009,-2200126,-34.376968749999996,2000
4743,2009-09-10,Trucker,1500000,52429,52429,2009,-1447571,-96.50473333333333,2000
5224,2009-09-10,Bronson,230000,2703762,104979,2009,2473762,1075.548695652174,2000
3581,2009-09-17,Bright Star,8500000,17220091,4444637,2009,8720091,102.58930588235293,2000
335,2009-09-18,Cloudy with a Chance of Meatballs,100000000,236827677,124870275,2009,136827677,136.827677,2000
2246,2009-09-18,The Informant!,22000000,41771168,33316821,2009,19771168,89.86894545454545,2000
2506,2009-09-18,The Burning Plain,20000000,1167092,200730,2009,-18832908,-94.16454,2000
2601,2009-09-18,Love Happens,18000000,36133014,22965110,2009,18133014,100.73896666666667,2000
2749,2009-09-18,Jennifer's Body,16000000,31943401,16204793,2009,15943401,99.64625625,2000
4874,2009-09-18,The Secrets of Jonathan Sperry,1000000,1355079,1355079,2009,355079,35.5079,2000
3483,2009-09-22,Adam Resurrected,10000000,90909,0,2009,-9909091,-99.09091,2000
2428,2009-09-23,Capitalism: A Love Story,20000000,19121531,14363397,2009,-878469,-4.392345000000001,2000
534,2009-09-25,Surrogates,80000000,119668350,38577772,2009,39668350,49.585437500000005,2000
1411,2009-09-25,Pandorum,40000000,17033431,10330853,2009,-22966569,-57.416422499999996,2000
2221,2009-09-25,Coco avant Chanel,23000000,50813834,6113834,2009,27813834,120.92971304347826,2000
2602,2009-09-25,Fame,18000000,80227619,22455510,2009,62227619,345.70899444444444,2000
3762,2009-09-25,I Hope They Serve Beer in Hell,7000000,1429453,1429299,2009,-5570547,-79.57924285714286,2000
1729,2009-10-04,Hannah Montana the Movie,30000000,169173206,79576189,2009,139173206,463.91068666666666,2000
1835,2009-10-04,Dragonball Evolution,30000000,58228460,9362785,2009,28228460,94.09486666666666,2000
2599,2009-10-04,Observe and Report,18000000,27148898,24007324,2009,9148898,50.82721111111111,2000
1252,2009-10-07,Brüno,42000000,130788243,60054530,2009,88788243,211.40057857142858,2000
2614,2009-10-07,"I Love You, Beth Cooper",18000000,16382538,14800725,2009,-1617462,-8.985899999999999,2000
344,2009-10-16,Where the Wild Things Are,100000000,99123656,77233467,2009,-876344,-0.8763440000000001,2000
978,2009-10-16,Law Abiding Citizen,53000000,131159781,73357727,2009,78159781,147.47128490566038,2000
2381,2009-10-16,The Stepfather,20000000,29227561,29062561,2009,9227561,46.137805,2000
3472,2009-10-16,Janky Promoters,10000000,9069,9069,2009,-9990931,-99.90930999999999,2000
747,2009-10-23,Astro Boy,65000000,41636243,19551067,2009,-23363757,-35.94424153846154,2000
1402,2009-10-23,Amelia,40000000,19756077,14279575,2009,-20243923,-50.6098075,2000
1403,2009-10-23,Cirque du Freak: The Vampire's Assistant,40000000,39753957,14046595,2009,-246043,-0.6151075,2000
2933,2009-10-23,Ong-Bak 2,15000000,7583050,102458,2009,-7416950,-49.44633333333333,2000
3257,2009-10-23,Saw VI,11000000,69752402,27693292,2009,58752402,534.1127454545455,2000
3465,2009-10-23,Motherhood,10000000,723388,93388,2009,-9276612,-92.76612,2000
3015,2009-10-27,Stan Helsing: A Parody,14000000,1553556,0,2009,-12446444,-88.90317142857143,2000
808,2009-10-28,Michael Jackson's This Is It,60000000,252091016,72091016,2009,192091016,320.15169333333336,2000
3499,2009-10-30,Gentlemen Broncos,9500000,118482,113682,2009,-9381518,-98.75282105263157,2000
3628,2009-10-30,The Boondock Saints 2: All Saints Day,8000000,10629320,10273187,2009,2629320,32.8665,2000
4904,2009-10-30,The House of the Devil,1000000,102812,101215,2009,-897188,-89.7188,2000
4978,2009-11-08,London to Brighton,825000,610776,0,2009,-214224,-25.966545454545454,2000
1607,2009-11-09,Whiteout,35000000,12254746,10275638,2009,-22745254,-64.98644,2000
2534,2009-11-09,I Can Do Bad All By Myself,19000000,51733921,51733921,2009,32733921,172.2837947368421,2000
3102,2009-11-09,Sorority Row,12500000,26735797,11965282,2009,14235797,113.886376,2000
5268,2009-11-09,The Horse Boy,160000,156612,156612,2009,-3388,-2.1174999999999997,2000
379,2009-11-12,The Lovely Bones,95000000,94894448,44114232,2009,-105552,-0.11110736842105264,2000
842,2009-11-12,Invictus,60000000,124514011,37491364,2009,64514011,107.52335166666667,2000
3741,2009-11-12,A Single Man,7000000,28142379,9176000,2009,21142379,302.0339857142857,2000
4838,2009-11-12,Rocket Singh: Salesman of the Year,1070000,5348767,164649,2009,4278767,399.8847663551402,2000
52,2009-11-13,2012,200000000,788408539,166112167,2009,588408539,294.2042695,2000
1112,2009-11-13,The Boat That Rocked,50000000,37472651,8017467,2009,-12527349,-25.054698,2000
1390,2009-11-13,The Fantastic Mr. Fox,40000000,47085064,21002919,2009,7085064,17.71266,2000
3816,2009-11-13,The Messenger,6500000,1744952,1109660,2009,-4755048,-73.1545846153846,2000
839,2009-11-20,Planet 51,60000000,108996113,42194060,2009,48996113,81.66018833333332,2000
1001,2009-11-20,The Twilight Saga: New Moon,50000000,687557727,296623634,2009,637557727,1275.115454,2000
1428,2009-11-20,Red Cliff,40000000,119627047,627047,2009,79627047,199.06761749999998,2000
1509,2009-11-20,The Blind Side,35000000,305705794,255959475,2009,270705794,773.4451257142857,2000
2144,2009-11-20,Bad Lieutenant: Port of Call New Orleans,25000000,12413949,1702112,2009,-12586051,-50.344204000000005,2000
4611,2009-11-20,The Missing Person,2000000,17896,17896,2009,-1982104,-99.10520000000001,2000
314,2009-11-25,The Princess and the Frog,105000000,270997378,104400899,2009,165997378,158.09274095238095,2000
1068,2009-11-25,Ninja Assassin,50000000,62209892,38122883,2009,12209892,24.419784,2000
1542,2009-11-25,Old Dogs,35000000,95104304,49492060,2009,60104304,171.72658285714286,2000
2131,2009-11-25,The Road,25000000,29206732,8114270,2009,4206732,16.826928,2000
2146,2009-11-25,Me and Orson Welles,25000000,1190003,1190003,2009,-23809997,-95.239988,2000
301,2009-12-06,The Taking of Pelham 123,110000000,152364370,65452312,2009,42364370,38.51306363636364,2000
959,2009-12-06,Imagine That,55000000,16123323,16123323,2009,-38876677,-70.68486727272727,2000
4035,2009-12-06,Moon,5000000,10676073,5010163,2009,5676073,113.52146,2000
4864,2009-12-06,"Food, Inc.",1000000,4731944,4417674,2009,3731944,373.1944,2000
3568,2009-12-16,Crazy Heart,8500000,47417251,39471742,2009,38917251,457.8500117647059,2000
1,2009-12-18,Avatar,425000000,2783918982,760507625,2009,2358918982,555.0397604705882,2000
546,2009-12-18,Nine,80000000,53508858,19676965,2009,-26491142,-33.1139275,2000
892,2009-12-18,Did You Hear About the Morgans?,58000000,80480566,29580087,2009,22480566,38.759596551724144,2000
1604,2009-12-18,The Young Victoria,35000000,31878891,11001272,2009,-3121109,-8.917454285714285,2000
637,2009-12-23,Alvin and the Chipmunks: The Squeakquel,70000000,443483213,219614612,2009,373483213,533.5474471428571,2000
398,2009-12-25,Sherlock Holmes,90000000,498438212,209028679,2009,408438212,453.8202355555556,2000
452,2009-12-25,It’s Complicated,85000000,224614744,112735375,2009,139614744,164.25263999999999,2000
1838,2009-12-25,The Imaginarium of Doctor Parnassus,30000000,64352607,7689607,2009,34352607,114.50868999999999,2000
4620,2009-12-29,Lesbian Vampire Killers,2000000,3620902,0,2009,1620902,81.0451,2000
2640,2009-12-30,Das Weisse Band: Eine deutsche Kindergeschichte,18000000,25727044,2222862,2009,7727044,42.928022222222225,2000
1489,2009-12-31,Obitaemyy ostrov,36500000,15000000,0,2009,-21500000,-58.9041095890411,2000
2226,2009-12-31,Shi Yue Wei Cheng,23000000,44195779,0,2009,21195779,92.15556086956522,2000
4512,2009-12-31,Nikté,2400000,1333891,0,2009,-1066109,-44.42120833333333,2000
4979,2009-12-31,Crying With Laughter,820000,16909,0,2009,-803091,-97.93792682926829,2000
5023,2009-12-31,Starsuckers,640000,14812,0,2009,-625188,-97.685625,2000
243,2010-01-04,Clash of the Titans,125000000,493214888,163214888,2010,368214888,294.57191040000004,2010
158,2010-01-07,The Last Airbender,150000000,319713881,131772187,2010,169713881,113.14258733333334,2010
2362,2010-01-09,The American,20000000,67950723,35606376,2010,47950723,239.753615,2010
5147,2010-01-09,My Dog Tulip,350000,310891,246574,2010,-39109,-11.174000000000001,2010
1291,2010-01-10,The Social Network,40000000,224922135,96962694,2010,184922135,462.30533749999995,2010
1953,2010-01-10,Case 39,27000000,28773827,13261851,2010,1773827,6.56972962962963,2010
2445,2010-01-10,Let Me In,20000000,28270399,12134935,2010,8270399,41.351995,2010
4402,2010-01-10,Chain Letter,3000000,1022453,205842,2010,-1977547,-65.91823333333333,2010
4438,2010-01-10,Freakonomics,2900000,172867,101270,2010,-2727133,-94.03906896551723,2010
512,2010-01-15,The Book of Eli,80000000,158750817,94835059,2010,78750817,98.43852125,2010
1914,2010-01-15,The Spy Next Door,28000000,46752858,24307106,2010,18752858,66.97449285714285,2010
2624,2010-01-15,The Last Station,18000000,15696146,6617867,2010,-2303854,-12.799188888888887,2010
4397,2010-01-15,Fish Tank,3000000,5922292,374675,2010,2922292,97.40973333333334,2010
1132,2010-01-22,The Tooth Fairy,48000000,112610386,60022256,2010,64610386,134.60497083333334,2010
1702,2010-01-22,Extraordinary Measures,31000000,15826984,12482741,2010,-15173016,-48.9452129032258,2010
1983,2010-01-22,Legion,26000000,67647574,40168080,2010,41647574,160.18297692307692,2010
3550,2010-01-22,La fille du RER,9000000,208163,208163,2010,-8791837,-97.68707777777777,2010
5054,2010-01-22,To Save a Life,500000,3824868,3777210,2010,3324868,664.9736,2010
5015,2010-01-26,B-Girl,700000,1160,0,2010,-698840,-99.83428571428571,2010
836,2010-01-29,Edge of Darkness,60000000,82812456,43313890,2010,22812456,38.020759999999996,2010
4601,2010-01-29,Saint John of Las Vegas,2000000,102645,102645,2010,-1897355,-94.86775,2010
1430,2010-02-04,The Warlords,40000000,38899792,129078,2010,-1100208,-2.75052,2010
2333,2010-02-04,Why Did I Get Married Too?,20000000,60831067,60095852,2010,40831067,204.155335,2010
3554,2010-02-04,Leaves of Grass,9000000,85527,70066,2010,-8914473,-99.0497,2010
3890,2010-02-04,The Greatest,6000000,117796,115862,2010,-5882204,-98.03673333333333,2010
3897,2010-02-04,Don McKay,6000000,13722,13722,2010,-5986278,-99.7713,2010
5370,2010-02-04,Breaking Upwards,15000,115592,115592,2010,100592,670.6133333333333,2010
500,2010-02-19,Shutter Island,80000000,299461782,128012934,2010,219461782,274.3272275,2010
1216,2010-02-19,The Ghost Writer,45000000,65532491,15541549,2010,20532491,45.62775777777778,2010
1851,2010-02-19,Le Petit Nicolas,30000000,52339566,201857,2010,22339566,74.46522,2010
3463,2010-02-19,Blood Done Sign My Name,10000000,109383,109383,2010,-9890617,-98.90617,2010
3464,2010-02-19,The Good Guy,10000000,106466,100688,2010,-9893534,-98.93534000000001,2010
4258,2010-02-19,Defendor,3750000,44462,44462,2010,-3705538,-98.81434666666667,2010
1484,2010-02-26,Cop Out,37000000,55909910,44875481,2010,18909910,51.10786486486486,2010
2539,2010-02-26,The Crazies,19000000,56445534,39123589,2010,37445534,197.08175789473685,2010
2784,2010-02-26,The Yellow Handkerchief,15500000,318623,318623,2010,-15181377,-97.94436774193548,2010
3081,2010-02-26,Un Prophète,13000000,19910624,2087720,2010,6910624,53.158646153846156,2010
4883,2010-03-02,Ajami,1000000,2721096,621859,2010,1721096,172.1096,2010
1682,2010-03-09,Going the Distance,32000000,43603990,17804299,2010,11603990,36.26246875,2010
3097,2010-03-09,Machete,12500000,46370970,26593646,2010,33870970,270.96776,2010
3217,2010-03-09,San qiang pai an jing qi,12000000,310946,190946,2010,-11689054,-97.40878333333333,2010
4914,2010-03-09,16 to Life,1000000,11574,11574,2010,-988426,-98.8426,2010
1267,2010-03-12,The Warrior's Way,42000000,8514325,5666340,2010,-33485675,-79.72779761904762,2010
2499,2010-03-12,All Good Things,20000000,873617,582024,2010,-19126383,-95.631915,2010
3032,2010-03-12,Black Swan,13000000,331266710,106954678,2010,318266710,2448.205461538462,2010
3082,2010-03-12,"I Love You, Phillip Morris",13000000,23014027,2037459,2010,10014027,77.03097692307692,2010
1179,2010-03-19,The Bounty Hunter,45000000,135808837,67061228,2010,90808837,201.79741555555557,2010
1684,2010-03-19,Repo Men,32000000,18195238,13942007,2010,-13804762,-43.13988125,2010
2807,2010-03-19,Diary of a Wimpy Kid,15000000,76954311,64003625,2010,61954311,413.02874,2010
3498,2010-03-19,The Runaways,9500000,5278632,3573673,2010,-4221368,-44.43545263157895,2010
3862,2010-03-19,City Island,6000000,8173486,6671283,2010,2173486,36.22476666666667,2010
110,2010-03-26,How to Train Your Dragon,165000000,494870991,217581231,2010,329870991,199.9218127272727,2010
1494,2010-03-26,Hot Tub Time Machine,36000000,65967750,50269859,2010,29967750,83.24375,2010
3078,2010-03-26,Chloe,13000000,11831131,3075255,2010,-1168869,-8.9913,2010
3775,2010-03-26,Ca$h,7000000,46488,46488,2010,-6953512,-99.33588571428571,2010
4405,2010-03-26,The Eclipse,3000000,133411,133411,2010,-2866589,-95.55296666666668,2010
2332,2010-03-31,The Last Song,20000000,92678948,62950384,2010,72678948,363.39473999999996,2010
598,2010-04-06,Killers,75000000,95572749,47059963,2010,20572749,27.430332,2010
1073,2010-04-06,Marmaduke,50000000,89895930,33644788,2010,39895930,79.79186,2010
1322,2010-04-06,Get Him to the Greek,40000000,91455875,61153526,2010,51455875,128.6396875,2010
1819,2010-04-06,Splice,30000000,26857459,17010170,2010,-3142541,-10.475136666666666,2010
3210,2010-04-06,Ondine,12000000,557545,550472,2010,-11442455,-95.35379166666667,2010
2512,2010-04-13,Three Kingdoms: Resurrection of the Dragon,20000000,22139590,0,2010,2139590,10.69795,2010
1900,2010-04-16,Kick-Ass,28000000,97531134,48071303,2010,69531134,248.32547857142856,2010
2287,2010-04-16,Death at a Funeral,21000000,48977233,42739347,2010,27977233,133.22491904761904,2010
3115,2010-04-16,The Perfect Game,12500000,3931367,1089445,2010,-8568633,-68.549064,2010
3434,2010-04-16,The Joneses,10000000,3541565,1475746,2010,-6458435,-64.58435,2010
3591,2010-04-16,The City of Your Final Destination,8300000,1353296,493296,2010,-6946704,-83.69522891566265,2010
4281,2010-04-16,El secreto de sus ojos,3500000,40527719,6391436,2010,37027719,1057.9348285714286,2010
548,2010-04-22,Oceans,80000000,86787530,19422319,2010,6787530,8.484412500000001,2010
1555,2010-04-23,The Back-up Plan,35000000,75281179,37490007,2010,40281179,115.08908285714286,2010
2086,2010-04-23,The Losers,25000000,29863840,23591432,2010,4863840,19.45536,2010
3461,2010-04-23,Joheunnom nabbeunnom isanghannom,10000000,42226657,128486,2010,32226657,322.26657,2010
1532,2010-04-30,A Nightmare on Elm Street,35000000,117729621,63075011,2010,82729621,236.3703457142857,2010
1593,2010-04-30,Furry Vengeance,35000000,39340177,17630465,2010,4340177,12.400505714285714,2010
3301,2010-04-30,Housefull,10100000,18726300,1183658,2010,8626300,85.4089108910891,2010
3491,2010-04-30,Gunless,9900000,458054,458054,2010,-9441946,-95.37319191919192,2010
3703,2010-04-30,Harry Brown,7300000,12023606,1818681,2010,4723606,64.70693150684932,2010
4253,2010-04-30,The Good Heart,3800000,340930,20930,2010,-3459070,-91.02815789473684,2010
4378,2010-04-30,Please Give,3000000,4570178,4033574,2010,1570178,52.33926666666666,2010
995,2010-05-02,From Paris With Love,52000000,53139168,24077427,2010,1139168,2.1907076923076922,2010
2023,2010-05-02,Dear John,25000000,142033509,80014842,2010,117033509,468.13403600000004,2010
3552,2010-05-02,The Red Riding Trilogy: 1974,9000000,148826,148826,2010,-8851174,-98.34637777777779,2010
44,2010-05-03,Alice in Wonderland,200000000,1025491110,334191110,2010,825491110,412.74555499999997,2010
2687,2010-05-03,Brooklyn's Finest,17000000,39233233,27163593,2010,22233233,130.78372352941176,2010
3646,2010-05-03,The Secret of Kells,8000000,3582797,690290,2010,-4417203,-55.215037499999994,2010
218,2010-05-11,Megamind,130000000,321887208,148415853,2010,191887208,147.60554461538462,2010
718,2010-05-11,Due Date,65000000,211739043,100539043,2010,146739043,225.75237384615386,2010
2290,2010-05-11,For Colored Girls,21000000,38017873,37729698,2010,17017873,81.03749047619047,2010
2605,2010-05-11,127 Hours,18000000,60217171,18335230,2010,42217171,234.5398388888889,2010
4257,2010-05-11,Four Lions,3750000,2436111,310007,2010,-1313889,-35.037040000000005,2010
33,2010-05-14,Robin Hood,210000000,322241588,105269730,2010,112241588,53.44837523809524,2010
1754,2010-05-14,Letters to Juliet,30000000,82148538,53032453,2010,52148538,173.82846,2010
3162,2010-05-14,Just Wright,12000000,21867665,21540363,2010,9867665,82.23054166666667,2010
3546,2010-05-14,Princess Kaiulani,9000000,883887,883887,2010,-8116113,-90.17903333333334,2010
5080,2010-05-14,The Living Wake,500000,12232,12232,2010,-487768,-97.55359999999999,2010
107,2010-05-21,Shrek Forever After,165000000,756244673,238736787,2010,591244673,358.3301048484849,2010
3109,2010-05-21,Solitary Man,12500000,4360548,4360548,2010,-8139452,-65.115616,2010
3393,2010-05-21,MacGruber,10000000,8629895,8525600,2010,-1370105,-13.70105,2010
3507,2010-05-21,Kites,9200000,17155193,1685269,2010,7955193,86.46948913043478,2010
3798,2010-05-21,Perrier’s Bounty,6600000,828,828,2010,-6599172,-99.98745454545454,2010
373,2010-05-27,Sex and the City 2,95000000,294680778,95347692,2010,199680778,210.19029263157893,2010
55,2010-05-28,Prince of Persia: Sands of Time,200000000,314594597,90759676,2010,114594597,57.297298500000004,2010
686,2010-05-28,Agora,70000000,38992292,619423,2010,-31007708,-44.296725714285714,2010
1269,2010-05-28,Micmacs,42000000,11756922,1259693,2010,-30243078,-72.00732857142857,2010
4029,2010-05-28,Sea Rex 3D: Journey to a Prehistoric World,5000000,16515203,6096582,2010,11515203,230.30406000000002,2010
4157,2010-05-28,George A. Romero's Survival of the Dead,4200000,101740,101740,2010,-4098260,-97.57761904761905,2010
336,2010-06-08,The Other Guys,100000000,170936470,119219978,2010,70936470,70.93647,2010
1771,2010-06-08,Step Up 3D,30000000,165889117,42400223,2010,135889117,452.96372333333335,2010
3008,2010-06-08,Flipped,14000000,4127619,1755212,2010,-9872381,-70.51700714285715,2010
3474,2010-06-08,The Oxford Murders,10000000,17704131,4803,2010,7704131,77.04131,2010
40,2010-06-18,Toy Story 3,200000000,1069818229,415004880,2010,869818229,434.9091145,2010
1149,2010-06-18,Jonah Hex,47000000,11022696,10547117,2010,-35977304,-76.54745531914894,2010
3091,2010-06-18,The Killer Inside Me,13000000,3617277,217277,2010,-9382723,-72.1747923076923,2010
3413,2010-06-18,Io sono l’amore,10000000,15132211,5005465,2010,5132211,51.322109999999995,2010
3744,2010-06-18,Cyrus,7000000,10062896,7468936,2010,3062896,43.75565714285714,2010
4495,2010-06-18,8: The Mormon Proposition,2500000,100280,100280,2010,-2399720,-95.9888,2010
271,2010-06-23,Knight and Day,117000000,258751370,76423035,2010,141751370,121.1550170940171,2010
579,2010-06-25,Grown Ups,75000000,272223430,162001186,2010,197223430,262.9645733333333,2010
3010,2010-06-25,Les herbes folles,14000000,1903952,403952,2010,-12096048,-86.40034285714286,2010
5155,2010-06-25,Dogtooth,323000,1373407,110248,2010,1050407,325.2034055727554,2010
689,2010-06-30,The Twilight Saga: Eclipse,68000000,706102828,300531751,2010,638102828,938.3865117647058,2010
2152,2010-06-30,Love Ranch,25000000,146149,137885,2010,-24853851,-99.415404,2010
98,2010-07-05,Iron Man 2,170000000,623561331,312433331,2010,453561331,266.80078294117646,2010
3764,2010-07-05,Mother and Child,7000000,6537179,1110509,2010,-462821,-6.611728571428571,2010
123,2010-07-14,The Sorcerer's Apprentice,160000000,217986320,63150991,2010,57986320,36.24145,2010
117,2010-07-16,Inception,160000000,832584416,292576195,2010,672584416,420.36526,2010
3914,2010-07-16,Valhalla Rising,5700000,731613,30638,2010,-4968387,-87.16468421052632,2010
3918,2010-07-16,Standing Ovation,5600000,531806,531806,2010,-5068194,-90.50346428571429,2010
221,2010-07-23,Salt,130000000,290650494,118311368,2010,160650494,123.57730307692307,2010
2851,2010-07-23,Ramona and Beezus,15000000,27469621,26167002,2010,12469621,83.13080666666667,2010
4131,2010-07-23,Life During Wartime,4500000,281447,281447,2010,-4218553,-93.74562222222222,2010
4139,2010-07-23,Spoken Word,4500000,32961,32961,2010,-4467039,-99.26753333333333,2010
465,2010-07-30,Cats & Dogs: The Revenge of Kitty Galore,85000000,114979922,45539292,2010,29979922,35.270496470588235,2010
688,2010-07-30,Dinner for Schmucks,69000000,86796502,73026337,2010,17796502,25.79203188405797,2010
1235,2010-07-30,Charlie St. Cloud,44000000,48478084,31206263,2010,4478084,10.177463636363635,2010
3740,2010-07-30,Get Low,7000000,10828305,9176933,2010,3828305,54.69007142857143,2010
3769,2010-07-30,The Extra Man,7000000,492108,453377,2010,-6507892,-92.96988571428571,2010
2378,2010-08-01,Daybreakers,20000000,51445503,30101577,2010,31445503,157.227515,2010
2542,2010-08-01,Leap Year,19000000,32618920,25918920,2010,13618920,71.67852631578947,2010
2612,2010-08-01,Youth in Revolt,18000000,19685588,15285588,2010,1685588,9.36437777777778,2010
1454,2010-08-10,Life as We Know It,38000000,105887837,53374681,2010,67887837,178.65220263157894,2010
1536,2010-08-10,Secretariat,35000000,60376247,59699513,2010,25376247,72.50356285714285,2010
2107,2010-08-10,My Soul to Take,25000000,16727470,14744435,2010,-8272530,-33.09012,2010
2274,2010-08-10,Stone,22000000,4065020,1810078,2010,-17934980,-81.52263636363635,2010
3478,2010-08-10,It's a Wonderful Afterlife,10000000,1642939,0,2010,-8357061,-83.57061,2010
3633,2010-08-10,It's Kind of a Funny Story,8000000,6632950,6363628,2010,-1367050,-17.088125,2010
4569,2010-08-10,Inside Job,2000000,7799257,4311834,2010,5799257,289.96285,2010
4651,2010-08-10,Nowhere Boy,1900000,7785229,1445366,2010,5885229,309.7488947368421,2010
4682,2010-08-10,I Spit on Your Grave,1750000,1278471,93051,2010,-471529,-26.944514285714288,2010
472,2010-08-13,Scott Pilgrim vs. The World,85000000,48056764,31611316,2010,-36943236,-43.4626305882353,2010
483,2010-08-13,The Expendables,82000000,268268174,103068524,2010,186268174,227.15630975609758,2010
798,2010-08-13,Eat Pray Love,60000000,206598789,80574010,2010,146598789,244.331315,2010
4156,2010-08-13,Animal Kingdom,4200000,8078683,1044039,2010,3878683,92.34959523809523,2010
2360,2010-08-18,Vampires Suck,20000000,81424988,36661504,2010,61424988,307.12494000000004,2010
1569,2010-08-20,Nanny McPhee and the Big Bang,35000000,97799865,29197642,2010,62799865,179.42818571428572,2010
2182,2010-08-20,Piranha 3D,24000000,83660160,25003155,2010,59660160,248.584,2010
2541,2010-08-20,The Switch,19000000,49858465,27758465,2010,30858465,162.41297368421053,2010
2630,2010-08-20,Mao's Last Dancer,18000000,25941437,4806750,2010,7941437,44.11909444444444,2010
2689,2010-08-20,Lottery Ticket,17000000,24719879,24719879,2010,7719879,45.41105294117647,2010
4093,2010-08-20,Soul Kitchen,4900000,23347469,276901,2010,18447469,376.47895918367345,2010
1668,2010-08-27,Takers,32000000,70587268,57744720,2010,38587268,120.58521250000001,2010
2932,2010-08-27,Centurion,15000000,7885048,123570,2010,-7114952,-47.433013333333335,2010
4614,2010-08-27,Circle,2000000,10024,10024,2010,-1989976,-99.4988,2010
4660,2010-08-27,The Last Exorcism,1800000,70165900,41034350,2010,68365900,3798.105555555556,2010
2777,2010-09-03,Hachiko: A Dog's Story,16000000,47707417,0,2010,31707417,198.17135625,2010
920,2010-09-04,Date Night,55000000,152269033,98711404,2010,97269033,176.85278727272726,2010
4136,2010-09-04,After.Life,4500000,2481925,108596,2010,-2018075,-44.84611111111111,2010
4388,2010-09-04,Letters to God,3000000,3237452,2848587,2010,237452,7.915066666666666,2010
4493,2010-09-04,Valley of the Hearts Delight,2500000,118666,118666,2010,-2381334,-95.25336,2010
4655,2010-09-04,The Square,1900000,740932,406216,2010,-1159068,-61.00357894736842,2010
687,2010-09-07,Despicable Me,69000000,543495033,251513985,2010,474495033,687.6739608695652,2010
1335,2010-09-07,Predators,40000000,127234389,52000688,2010,87234389,218.0859725,2010
3920,2010-09-07,[Rec] 2,5600000,18527766,27766,2010,12927766,230.85296428571428,2010
4172,2010-09-07,The Kids Are All Right,4000000,36275469,20811365,2010,32275469,806.8867250000001,2010
2917,2010-09-15,Never Let Me Go,15000000,11173718,2434652,2010,-3826282,-25.508546666666664,2010
1479,2010-09-17,The Town,37000000,152566881,92186262,2010,115566881,312.3429216216216,2010
2391,2010-09-17,Alpha and Omega 3D,20000000,48958353,25107267,2010,28958353,144.791765,2010
3330,2010-09-17,Devil,10000000,63354114,33679655,2010,53354114,533.54114,2010
3601,2010-09-17,Easy A,8000000,76200721,58401464,2010,68200721,852.5090125,2010
3792,2010-09-17,Incendies,6800000,16038343,6857096,2010,9238343,135.85798529411767,2010
2916,2010-09-22,You Will Meet a Tall Dark Stranger,15000000,34247816,3247816,2010,19247816,128.31877333333333,2010
352,2010-09-24,Legend of the Guardians: The Owls of Ga'Hoole,100000000,139716717,55675313,2010,39716717,39.716717,2010
663,2010-09-24,Wall Street 2: Money Never Sleeps,70000000,137431619,52474616,2010,67431619,96.33088428571429,2010
2389,2010-09-24,You Again,20000000,32838945,25702053,2010,12838945,64.19472499999999,2010
2773,2010-09-24,Enter the Void,16000000,1467278,337997,2010,-14532722,-90.82951249999999,2010
4590,2010-09-24,The Virginity Hit,2000000,636706,636706,2010,-1363294,-68.1647,2010
4647,2010-09-24,Buried,1987650,21270290,1044143,2010,19282640,970.1225064774986,2010
3227,2010-10-02,Triangle,12000000,1595168,0,2010,-10404832,-86.70693333333334,2010
895,2010-10-09,Resident Evil: Afterlife,57500000,295874190,60128566,2010,238374190,414.5638086956522,2010
3796,2010-10-09,Bran Nue Dae,6750000,6812530,113568,2010,62530,0.9263703703703705,2010
4063,2010-10-09,"Lovely, Still",5000000,282687,127564,2010,-4717313,-94.34626,2010
1370,2010-10-11,Morning Glory,40000000,59795070,31011732,2010,19795070,49.487674999999996,2010
128,2010-10-12,The Chronicles of Narnia: The Voyage of the Dawn Treader,155000000,418186950,104386950,2010,263186950,169.79803225806452,2010
347,2010-10-12,The Tourist,100000000,278731369,67631157,2010,178731369,178.731369,2010
2504,2010-10-12,The Tempest,20000000,277943,277943,2010,-19722057,-98.610285,2010
3242,2010-10-12,The Fighter,11000000,129262388,93617009,2010,118262388,1075.112618181818,2010
794,2010-10-15,Red,60000000,196439693,90380162,2010,136439693,227.39948833333332,2010
1075,2010-10-15,Hereafter,50000000,105246941,32746941,2010,55246941,110.49388200000001,2010
2316,2010-10-15,Jackass 3D,20000000,171685793,117229692,2010,151685793,758.428965,2010
2646,2010-10-15,Carlos,18000000,157002,145526,2010,-17842998,-99.12776666666666,2010
3107,2010-10-15,Conviction,12500000,11826980,6797696,2010,-673020,-5.3841600000000005,2010
4697,2010-10-15,N-Secure,1600000,2595644,2595644,2010,995644,62.22775,2010
5130,2010-10-15,I Want Your Money,400000,433588,433588,2010,33588,8.397,2010
5351,2010-10-15,Down Terrace,30000,9812,9812,2010,-20188,-67.29333333333334,2010
4331,2010-10-20,Paranormal Activity 2,3000000,177512032,84752907,2010,174512032,5817.067733333333,2010
2678,2010-10-29,Saw 3D,17000000,133735284,45710178,2010,116735284,686.6781411764705,2010
3456,2010-10-29,Welcome to the Rileys,10000000,355919,152857,2010,-9644081,-96.44081,2010
3656,2010-10-29,Wild Target,8000000,5314194,109338,2010,-2685806,-33.572575,2010
5069,2010-10-29,Monsters,500000,5639730,237301,2010,5139730,1027.946,2010
2776,2010-11-05,Haeundae,16000000,64733391,0,2010,48733391,304.58369375,2010
298,2010-11-06,The A-Team,110000000,177241171,77222099,2010,67241171,61.12833727272727,2010
1278,2010-11-06,The Karate Kid,40000000,351774938,176591618,2010,311774938,779.437345,2010
4562,2010-11-06,Winter's Bone,2000000,16131551,6531503,2010,14131551,706.57755,2010
4616,2010-11-06,Jerusalema,2000000,10679,7294,2010,-1989321,-99.46605,2010
235,2010-11-19,Harry Potter and the Deathly Hallows: Part I,125000000,960283305,295983305,2010,835283305,668.2266440000001,2010
1806,2010-11-19,The Next Three Days,30000000,67255916,21148651,2010,37255916,124.18638666666666,2010
3644,2010-11-19,Made in Dagenham,8000000,15644196,1095369,2010,7644196,95.55245,2010
8,2010-11-24,Tangled,260000000,586581936,200821936,2010,326581936,125.60843692307692,2010
433,2010-11-24,The Nutcracker in 3D,90000000,20466016,195459,2010,-69533984,-77.25998222222222,2010
945,2010-11-24,Burlesque,55000000,90552675,39440655,2010,35552675,64.64122727272728,2010
1789,2010-11-24,Love and Other Drugs,30000000,102716321,32367005,2010,72716321,242.38773666666668,2010
2183,2010-11-24,Faster,24000000,35792945,23240020,2010,11792945,49.13727083333333,2010
2792,2010-11-26,The King’s Speech,15000000,430821168,138797449,2010,415821168,2772.14112,2010
167,2010-12-02,The Wolfman,150000000,142634358,62189884,2010,-7365642,-4.910428,2010
374,2010-12-02,Percy Jackson & the Olympians: The Lightning Thief,95000000,223050874,88768303,2010,128050874,134.79039368421053,2010
990,2010-12-02,Valentine's Day,52000000,217569328,110485654,2010,165569328,318.40255384615386,2010
3586,2010-12-02,My Name is Khan,8470000,42355526,4046336,2010,33885526,400.0652420306966,2010
359,2010-12-03,Green Zone,100000000,97523020,35497337,2010,-2476980,-2.47698,2010
2373,2010-12-03,She's Out of My League,20000000,48680977,32010860,2010,28680977,143.40488499999998,2010
2747,2010-12-03,Remember Me,16000000,56506120,19068240,2010,40506120,253.16325,2010
2981,2010-12-03,Our Family Wedding,14000000,21410546,20255281,2010,7410546,52.932471428571425,2010
5343,2010-12-03,The Exploding Girl,40000,25572,25572,2010,-14428,-36.07,2010
376,2010-12-11,Unstoppable,95000000,169511609,81562942,2010,74511609,78.43327263157894,2010
3355,2010-12-11,Skyline,10000000,78693371,21416355,2010,68693371,686.93371,2010
5331,2010-12-11,Tiny Furniture,50000,424149,391674,2010,374149,748.298,2010
51,2010-12-17,Tron: Legacy,200000000,400062763,172062763,2010,200062763,100.0313815,2010
270,2010-12-17,How Do You Know?,120000000,49628177,30212620,2010,-70371823,-58.643185833333334,2010
510,2010-12-17,Yogi Bear,80000000,204774690,100246011,2010,124774690,155.96836249999998,2010
3111,2010-12-17,Casino Jack,12500000,2272186,2039869,2010,-10227814,-81.822512,2010
4046,2010-12-17,Rabbit Hole,5000000,6205034,2229058,2010,1205034,24.10068,2010
332,2010-12-22,Little Fockers,100000000,310650574,148438600,2010,210650574,210.65057399999998,2010
1512,2010-12-22,True Grit,35000000,252276928,171243005,2010,217276928,620.7912228571429,2010
2862,2010-12-22,Country Strong,15000000,20601987,20218921,2010,5601987,37.34658,2010
3758,2010-12-22,Somewhere,7000000,17023121,1785645,2010,10023121,143.18744285714286,2010
281,2010-12-25,Gulliver's Travels,112000000,232017848,42779261,2010,120017848,107.15879285714284,2010
2706,2010-12-25,L'illusionniste,17000000,8609949,2231474,2010,-8390051,-49.35324117647058,2010
3640,2010-12-29,Another Year,8000000,20005613,3205706,2010,12005613,150.0701625,2010
4853,2010-12-29,Blue Valentine,1000000,16566240,9737892,2010,15566240,1556.624,2010
1855,2010-12-31,Konferenz der Tiere,30000000,53048539,0,2010,23048539,76.82846333333333,2010
2154,2010-12-31,Sammy's avonturen: De geheime doorgang,25000000,71594792,0,2010,46594792,186.379168,2010
2155,2010-12-31,Belka i Strelka. Zvezdnye sobaki,25000000,9445081,0,2010,-15554919,-62.219676,2010
3476,2010-12-31,The Reef,10000000,15037867,0,2010,5037867,50.37867,2010
3509,2010-12-31,Mine Vaganti,9100000,18872126,0,2010,9772126,107.38600000000001,2010
760,2011-01-04,Hop,63000000,188657593,108085305,2011,125657593,199.45649682539684,2010
1669,2011-01-04,Source Code,32000000,140428499,54712227,2011,108428499,338.83905937500003,2010
3027,2011-01-04,The Last Godfather,13400000,164247,164247,2011,-13235753,-98.77427611940298,2010
3934,2011-01-04,Haevnen,5500000,15867314,1008098,2011,10367314,188.49661818181818,2010
4224,2011-01-04,Trust,4000000,120016,120016,2011,-3879984,-96.9996,2010
4491,2011-01-04,Super,2500000,593933,327716,2011,-1906067,-76.24268,2010
4706,2011-01-04,Insidious,1500000,99870886,54009150,2011,98370886,6558.059066666667,2010
5073,2011-01-04,Rubber,500000,680914,100370,2011,180914,36.1828,2010
1786,2011-01-07,Larry Crowne,30000000,61449135,35608245,2011,31449135,104.83045,2010
2394,2011-01-07,Monte Carlo,20000000,39686769,23186769,2011,19686769,98.43384499999999,2010
4908,2011-01-07,The Perfect Host,1000000,51587,48764,2011,-948413,-94.84129999999999,2010
295,2011-01-14,The Green Hornet,110000000,229155503,98780042,2011,119155503,108.32318454545455,2010
664,2011-01-14,The Dilemma,70000000,70546865,48475290,2011,546865,0.7812357142857143,2010
1839,2011-01-14,Barney's Version,30000000,8845575,7502560,2011,-21154425,-70.51475,2010
4252,2011-01-14,Down for Life,3800000,41914,41914,2011,-3758086,-98.897,2010
2030,2011-01-21,No Strings Attached,25000000,149228078,70662220,2011,124228078,496.912312,2010
1245,2011-01-28,The Mechanic,42500000,76347393,29121498,2011,33847393,79.64092470588236,2010
1485,2011-01-28,The Rite,37000000,97143987,33047633,2011,60143987,162.5513162162162,2010
1619,2011-01-28,Biutiful,35000000,24687524,5101237,2011,-10312476,-29.46421714285714,2010
2093,2011-02-09,Shark Night 3D,25000000,32209741,18877153,2011,7209741,28.838964,2010
3995,2011-02-09,Apollo 18,5000000,26517819,17686929,2011,21517819,430.35638,2010
4127,2011-02-09,Salvando al Soldado Perez,4500000,9330465,1400726,2011,4830465,107.34366666666666,2010
3812,2011-02-12,Shame,6500000,20412841,4002293,2011,13912841,214.04370769230766,2010
1043,2011-02-18,I am Number Four,50000000,146195159,55100437,2011,96195159,192.39031799999998,2010
1321,2011-02-18,Unknown,40000000,136123083,63686397,2011,96123083,240.30770750000002,2010
1673,2011-02-18,"Big Mommas: Like Father, Like Son",32000000,82332450,37915414,2011,50332450,157.28890625,2010
693,2011-02-25,Hall Pass,68000000,87173475,45060734,2011,19173475,28.19628676470588,2010
1105,2011-02-25,Drive Angry,50000000,41042583,10721033,2011,-8957417,-17.914834,2010
4040,2011-02-25,Des Hommes et Des Dieux,5000000,46263525,3954651,2011,41263525,825.2705000000001,2010
5233,2011-02-25,The Grace Card,200000,2430735,2430735,2011,2230735,1115.3675,2010
121,2011-03-06,X-Men: First Class,160000000,355408305,146408305,2011,195408305,122.13019062499998,2010
4324,2011-03-06,Beginners,3200000,14314407,5790894,2011,11114407,347.32521875,2010
4654,2011-03-06,Submarine,1900000,4581937,467602,2011,2681937,141.15457894736844,2010
1325,2011-03-18,The Lincoln Lawyer,40000000,87145086,58009200,2011,47145086,117.86271500000001,2010
1357,2011-03-18,Paul,40000000,101162106,37412945,2011,61162106,152.90526499999999,2010
1937,2011-03-18,Limitless,27000000,155564919,79249455,2011,128564919,476.16636666666665,2010
3908,2011-03-18,Winter in Wartime,5800000,9662214,542860,2011,3862214,66.58989655172414,2010
606,2011-03-25,Sucker Punch,75000000,89758389,36392502,2011,14758389,19.677852,2010
2580,2011-03-25,Diary of a Wimpy Kid: Rodrick Rules,18000000,73695194,52698535,2011,55695194,309.41774444444445,2010
3884,2011-03-25,The 5th Quarter,6000000,408159,408159,2011,-5591841,-93.19735,2010
1803,2011-04-02,Sanctum,30000000,104283753,23209310,2011,74283753,247.61251,2010
2736,2011-04-02,The Roommate,16000000,52545707,37300107,2011,36545707,228.41066875,2010
203,2011-04-03,Rango,135000000,245504574,123257581,2011,110504574,81.85524,2010
1000,2011-04-03,The Adjustment Bureau,50200000,126931325,62495645,2011,76731325,152.8512450199203,2010
2550,2011-04-03,Take Me Home Tonight,19000000,7576604,6928068,2011,-11423396,-60.12313684210526,2010
2686,2011-04-03,Beastly,17000000,38028230,27865571,2011,21028230,123.6954705882353,2010
3888,2011-04-03,Akmareul Boatda,6000000,13168809,129210,2011,7168809,119.48015000000001,2010
2156,2011-04-10,La véritable histoire du Chat Botté,25000000,8208594,0,2011,-16791406,-67.16562400000001,2010
455,2011-04-11,Tower Heist,85000000,150422946,78046570,2011,65422946,76.96817176470589,2010
2364,2011-04-11,A Very Harold & Kumar 3D Christmas,20000000,36265745,35061031,2011,16265745,81.328725,2010
2937,2011-04-11,The Son of No One,15000000,1148578,30680,2011,-13851422,-92.34281333333332,2010
401,2011-04-15,Rio,90000000,487519809,143619809,2011,397519809,441.6886766666667,2010
1354,2011-04-15,Scream 4,40000000,95989590,38180928,2011,55989590,139.973975,2010
2118,2011-04-15,The Conspirator,25000000,15907411,11538204,2011,-9092589,-36.370356,2010
1453,2011-04-22,Water for Elephants,38000000,116809717,58709717,2011,78809717,207.39399210526318,2010
2038,2011-04-22,Madea's Big Happy Family,25000000,53345287,53345287,2011,28345287,113.38114800000001,2010
3951,2011-04-22,Dum Maaro Dum,5200000,11633427,564489,2011,6433427,123.71974999999999,2010
4228,2011-04-22,Stake Land,4000000,679482,33245,2011,-3320518,-83.01294999999999,2010
4671,2011-04-22,POM Wonderful Presents: The Greatest Movie Ever Sold,1800000,783733,638476,2011,-1016267,-56.459277777777785,2010
238,2011-04-29,Fast Five,125000000,629969804,209837675,2011,504969804,403.97584320000004,2010
1834,2011-04-29,Hoodwinked Too: Hood vs. Evil,30000000,23353111,10143779,2011,-6646889,-22.156296666666666,2010
2494,2011-04-29,Dylan Dog: Dead of Night,20000000,6093725,1186538,2011,-13906275,-69.531375,2010
3629,2011-04-29,Prom,8000000,10763183,10130219,2011,2763183,34.5397875,2010
388,2011-05-08,Rise of the Planet of the Apes,93000000,482860185,176760185,2011,389860185,419.20450000000005,2010
992,2011-05-08,The Change-Up,52000000,75835124,37081475,2011,23835124,45.83677692307692,2010
856,2011-05-13,Priest,60000000,84154026,29136626,2011,24154026,40.25671,2010
1658,2011-05-13,Bridesmaids,32500000,289527030,169106725,2011,257027030,790.8524,2010
3770,2011-05-13,Hesher,7000000,382946,382946,2011,-6617054,-94.52934285714286,2010
4044,2011-05-13,Everything Must Go,5000000,2821010,2712131,2011,-2178990,-43.5798,2010
4508,2011-05-13,Go For It!,2450000,182358,180237,2011,-2267642,-92.55681632653061,2010
17,2011-05-20,Pirates of the Caribbean: On Stranger Tides,250000000,1045663875,241063875,2011,795663875,318.26555,2010
1750,2011-05-20,Midnight in Paris,30000000,162838373,56816662,2011,132838373,442.7945766666666,2010
4780,2011-05-24,Forget Me Not,1300000,13465,0,2011,-1286535,-98.96423076923077,2010
152,2011-05-26,Kung Fu Panda 2,150000000,664837547,165249063,2011,514837547,343.22503133333333,2010
487,2011-05-26,The Hangover Part II,80000000,586464305,254464305,2011,506464305,633.08038125,2010
1600,2011-05-27,The Tree of Life,35000000,61721826,13305665,2011,26721826,76.34807428571429,2010
3704,2011-05-27,Die Welle,7250000,35122948,0,2011,27872948,384.4544551724138,2010
148,2011-06-05,Thor,150000000,449326618,181030624,2011,299326618,199.55107866666665,2010
1505,2011-06-05,There Be Dragons,36000000,4020990,1069334,2011,-31979010,-88.83058333333334,2010
1552,2011-06-05,Something Borrowed,35000000,65084116,39046489,2011,30084116,85.95461714285715,2010
2300,2011-06-05,The Beaver,21000000,5046038,970816,2011,-15953962,-75.97124761904762,2010
3713,2011-06-05,Jumping the Broom,7000000,38158601,37295394,2011,31158601,445.12287142857144,2010
4395,2011-06-05,Hobo with a Shotgun,3000000,834953,703372,2011,-2165047,-72.16823333333333,2010
54,2011-06-17,Green Lantern,200000000,219535492,116601172,2011,19535492,9.767745999999999,2010
930,2011-06-17,Mr. Poppers's Penguins,55000000,189624452,68224452,2011,134624452,244.77173090909093,2010
4205,2011-06-17,The Art of Getting By,4000000,1989035,1430241,2011,-2010965,-50.274125000000005,2010
3479,2011-06-21,You Got Served: Beat The World,10000000,1230542,0,2011,-8769458,-87.69458,2010
50,2011-06-24,Cars 2,200000000,560155383,191450875,2011,360155383,180.0776915,2010
2530,2011-06-24,Bad Teacher,19000000,215448997,100292856,2011,196448997,1033.942089473684,2010
3430,2011-06-24,A Better Life,10000000,1884251,1759252,2011,-8115749,-81.15749,2010
4110,2011-06-24,Le nom des gens,4600000,9261711,514237,2011,4661711,101.34154347826087,2010
56,2011-06-29,Transformers: Dark of the Moon,195000000,1123790543,352390543,2011,928790543,476.3028425641026,2010
1384,2011-07-01,Season of the Witch,40000000,91126600,24827228,2011,51126600,127.8165,2010
297,2011-07-10,Real Steel,110000000,263880341,85463309,2011,153880341,139.8912190909091,2010
1852,2011-07-10,Xinhai geming,30000000,8593154,135739,2011,-21406846,-71.35615333333334,2010
2203,2011-07-10,The Ides of March,23000000,77735925,40962534,2011,54735925,237.98228260869564,2010
4133,2011-07-10,Blackthorn,4500000,1217307,200558,2011,-3282693,-72.94873333333334,2010
231,2011-07-15,Harry Potter and the Deathly Hallows: Part II,125000000,1341511219,381011219,2011,1216511219,973.2089752,2010
1798,2011-07-15,Winnie the Pooh,30000000,50145607,26692846,2011,20145607,67.15202333333333,2010
3880,2011-07-15,Snow Flower and the Secret Fan,6000000,11348205,1348205,2011,5348205,89.13674999999999,2010
3937,2011-07-15,Salvation Boulevard,5500000,28468,28468,2011,-5471532,-99.4824,2010
184,2011-07-22,Captain America: The First Avenger,140000000,370569776,176654505,2011,230569776,164.69269714285716,2010
1538,2011-07-22,Friends with Benefits,35000000,146595891,55802754,2011,111595891,318.84540285714286,2010
2954,2011-07-22,Elle s'appelait Sarah,14500000,25480031,7691700,2011,10980031,75.72435172413793,2010
5262,2011-07-22,Another Earth,175000,2102779,1321194,2011,1927779,1101.588,2010
114,2011-07-29,Cowboys and Aliens,163000000,175910315,100240551,2011,12910315,7.920438650306748,2010
286,2011-07-29,The Smurfs,110000000,563749323,142614158,2011,453749323,412.4993845454545,2010
1024,2011-07-29,"Crazy, Stupid, Love",50000000,147142328,84351197,2011,97142328,194.284656,2010
2526,2011-07-29,The Devil's Double,19100000,2406666,1361512,2011,-16693334,-87.39965445026178,2010
3087,2011-07-29,Attack the Block,13000000,6459183,1024175,2011,-6540817,-50.31397692307692,2010
3864,2011-07-29,The Guard,6000000,21197454,5359774,2011,15197454,253.29090000000002,2010
4885,2011-07-29,The Future,1000000,1239174,568662,2011,239174,23.9174,2010
5041,2011-07-29,The Harvest/La Cosecha,560000,3709,3709,2011,-556291,-99.33767857142857,2010
1092,2011-08-04,Your Highness,50000000,26121638,21596445,2011,-23878362,-47.756724,2010
1365,2011-08-04,Arthur,40000000,47787943,33035397,2011,7787943,19.4698575,2010
1776,2011-08-04,Hanna,30000000,65343694,40259119,2011,35343694,117.81231333333334,2010
2583,2011-08-04,Soul Surfer,18000000,47158652,43853424,2011,29158652,161.9925111111111,2010
4587,2011-08-04,Meek's Cutoff,2000000,1869928,977772,2011,-130072,-6.5036,2010
518,2011-08-07,Zookeeper,80000000,170805525,80360866,2011,90805525,113.50690625,2010
1517,2011-08-07,Horrible Bosses,35000000,212417601,117538559,2011,177417601,506.90743142857144,2010
2157,2011-08-07,Ironclad,25000000,5297411,0,2011,-19702589,-78.810356,2010
5058,2011-08-07,Sholem Aleichem: Laughing in the Darkness,500000,1131261,1131261,2011,631261,126.25219999999999,2010
430,2011-08-19,Conan the Barbarian,90000000,63356133,21295021,2011,-26643867,-29.60429666666667,2010
1815,2011-08-19,Fright Night,30000000,40520649,18298649,2011,10520649,35.06883,2010
1946,2011-08-19,Spy Kids: All the Time in the World,27000000,80681183,38536376,2011,53681183,198.8191962962963,2010
2874,2011-08-19,One Day,15000000,59168692,13843771,2011,44168692,294.45794666666666,2010
3222,2011-08-19,5 Days of War,12000000,87793,17479,2011,-11912207,-99.26839166666667,2010
4129,2011-08-19,Nannerl la soeur de Mozart,4500000,2404639,707885,2011,-2095361,-46.56357777777777,2010
4439,2011-08-19,Griff the Invisible,2900000,25935,20778,2011,-2874065,-99.10568965517241,2010
4735,2011-08-19,Amigo,1500000,184705,184705,2011,-1315295,-87.68633333333334,2010
4670,2011-08-23,Higher Ground,1800000,842693,841056,2011,-957307,-53.183722222222215,2010
1359,2011-08-26,Colombiana,40000000,72295262,36665854,2011,32295262,80.738155,2010
2085,2011-08-26,Don't Be Afraid of the Dark,25000000,39126427,24046682,2011,14126427,56.505708,2010
3281,2011-08-26,Brighton Rock,11000000,229653,229653,2011,-10770347,-97.91224545454546,2010
3980,2011-08-26,Our Idiot Brother,5000000,25861249,24814830,2011,20861249,417.22498,2010
4520,2011-08-26,Redemption Road,2300000,29384,29384,2011,-2270616,-98.72243478260869,2010
4963,2011-08-26,Circumstance,900000,958978,454121,2011,58978,6.553111111111111,2010
2376,2011-08-31,The Debt,20000000,46604054,31177548,2011,26604054,133.02027,2010
802,2011-09-09,Contagion,60000000,137551594,75658097,2011,77551594,129.25265666666667,2010
2113,2011-09-09,Warrior,25000000,24215385,13657115,2011,-784615,-3.13846,2010
3425,2011-09-09,Bucky Larson: Born to Be a Star,10000000,2529395,2529395,2011,-7470605,-74.70605,2010
4398,2011-09-09,Creature,3000000,331000,331000,2011,-2669000,-88.96666666666667,2010
4413,2011-09-09,Tanner Hall,3000000,5073,5073,2011,-2994927,-99.8309,2010
4621,2011-09-09,Grave Encounters,2000000,2151887,0,2011,151887,7.5943499999999995,2010
4996,2011-09-09,Kevin Hart: Laugh at My Pain,750000,7712436,7706436,2011,6962436,928.3248000000001,2010
1556,2011-09-11,J. Edgar,35000000,84606030,37306030,2011,49606030,141.7315142857143,2010
1977,2011-09-12,New Year’s Eve,26000000,146850273,54544638,2011,120850273,464.80874230769234,2010
2074,2011-09-12,The Sitter,25000000,38749404,30542576,2011,13749404,54.99761600000001,2010
2294,2011-09-12,Tinker Tailor Soldier Spy,21000000,81452811,24149393,2011,60452811,287.87052857142857,2010
3171,2011-09-12,Young Adult,12000000,22750356,16311571,2011,10750356,89.5863,2010
2126,2011-09-16,Straw Dogs,25000000,11253821,10324441,2011,-13746179,-54.984716,2010
2188,2011-09-16,I Don't Know How She Does It,24000000,24474463,9659074,2011,474463,1.9769291666666668,2010
2829,2011-09-16,Drive,15000000,78054825,35060689,2011,63054825,420.36550000000005,2010
3653,2011-09-16,Restless,8000000,2772511,163753,2011,-5227489,-65.3436125,2010
3707,2011-09-16,3,7200000,295492,59774,2011,-6904508,-95.89594444444445,2010
676,2011-09-23,Killer Elite,70000000,65409046,25124986,2011,-4590954,-6.558505714285714,2010
1030,2011-09-23,Moneyball,50000000,111300835,75605492,2011,61300835,122.60167,2010
1480,2011-09-23,Dolphin Tale,37000000,96068724,72286779,2011,59068724,159.6452,2010
1572,2011-09-23,Abduction,35000000,86648359,28087155,2011,51648359,147.56674,2010
1849,2011-09-23,Machine Gun Preacher,30000000,3721988,538690,2011,-26278012,-87.59337333333333,2010
4207,2011-09-23,Red State,4000000,1983596,1065429,2011,-2016404,-50.4101,2010
5258,2011-09-23,Weekend,190000,1577585,484592,2011,1387585,730.3078947368422,2010
1094,2011-09-30,Dream House,50000000,41642166,21302340,2011,-8357834,-16.715668,2010
2431,2011-09-30,What's Your Number?,20000000,30163785,14011084,2011,10163785,50.81892500000001,2010
3013,2011-09-30,Margaret,14000000,623292,47185,2011,-13376708,-95.54791428571428,2010
3606,2011-09-30,50/50,8000000,41334735,35016118,2011,33334735,416.6841875,2010
4061,2011-09-30,Tucker & Dale vs. Evil,5000000,5476793,223838,2011,476793,9.53586,2010
4099,2011-09-30,Take Shelter,4750000,4972016,1728953,2011,222016,4.674021052631579,2010
4542,2011-09-30,Courageous,2000000,35185884,34522221,2011,33185884,1659.2942,2010
1013,2011-10-06,Super 8,50000000,257972745,127004179,2011,207972745,415.94549,2010
4286,2011-10-06,Trolljegeren,3500000,5706638,253444,2011,2206638,63.046800000000005,2010
2009,2011-10-08,The Help,25000000,213120004,169705587,2011,188120004,752.480016,2010
1275,2011-10-14,The Big Year,41000000,7684524,7204138,2011,-33315476,-81.25725853658537,2010
1467,2011-10-14,The Thing,38000000,27501814,16928670,2011,-10498186,-27.626805263157895,2010
1628,2011-10-14,Trespass,35000000,786532,16816,2011,-34213468,-97.75276571428572,2010
2170,2011-10-14,Footloose,24000000,62989834,51802742,2011,38989834,162.4576416666667,2010
3662,2011-10-14,Fireflies in the Garden,8000000,3505823,36884,2011,-4494177,-56.177212499999996,2010
431,2011-10-21,The Three Musketeers,90000000,139877913,20377913,2011,49877913,55.41990333333333,2010
1223,2011-10-21,Johnny English Reborn,45000000,164539660,8305970,2011,119539660,265.6436888888889,2010
3757,2011-10-21,The Mighty Macs,7000000,1891936,1891936,2011,-5108064,-72.97234285714286,2010
3935,2011-10-21,Le Havre,5500000,13480196,611709,2011,7980196,145.09447272727272,2010
3956,2011-10-21,Paranormal Activity 3,5000000,202053386,104028807,2011,197053386,3941.06772,2010
4158,2011-10-21,Cargo,4200000,313230,0,2011,-3886770,-92.54214285714286,2010
4305,2011-10-21,Margin Call,3400000,20433227,5353586,2011,17033227,500.9772647058823,2010
4867,2011-10-21,Martha Marcy May Marlene,1000000,5438911,2981038,2011,4438911,443.8911,2010
217,2011-10-28,Puss in Boots,130000000,554987477,149260504,2011,424987477,326.9134438461538,2010
1221,2011-10-28,The Rum Diary,45000000,21544732,13109815,2011,-23455268,-52.122817777777776,2010
1554,2011-10-28,In Time,35000000,165103952,37553932,2011,130103952,371.72557714285716,2010
1936,2011-10-28,Anonymous,27500000,15815509,4463292,2011,-11684491,-42.48905818181819,2010
5189,2011-10-28,Like Crazy,250000,3731489,3395391,2011,3481489,1392.5955999999999,2010
506,2011-11-02,Just Go With It,80000000,214974953,103028109,2011,134974953,168.71869125,2010
1490,2011-11-02,Gnomeo and Juliet,36000000,193737977,99967670,2011,157737977,438.16104722222224,2010
2091,2011-11-02,The Eagle,25000000,36054706,19490041,2011,11054706,44.218824,2010
3034,2011-11-02,Justin Bieber: Never Say Never,13000000,99034125,73013910,2011,86034125,661.8009615384615,2010
3402,2011-11-02,Cedar Rapids,10000000,7862131,6861102,2011,-2137869,-21.37869,2010
4733,2011-11-02,MOOZ-lum,1500000,372239,362239,2011,-1127761,-75.18406666666667,2010
4811,2011-11-02,Certifiably Jonathan,1200000,7826,7826,2011,-1192174,-99.34783333333334,2010
5344,2011-11-02,Raymond Did It,40000,3632,3632,2011,-36368,-90.92,2010
170,2011-11-03,Mars Needs Moms,150000000,39549758,21392758,2011,-110450242,-73.63349466666666,2010
650,2011-11-03,Battle: Los Angeles,70000000,213463976,83552429,2011,143463976,204.94853714285713,2010
1258,2011-11-03,Red Riding Hood,42000000,91678442,37662162,2011,49678442,118.28200476190476,2010
3207,2011-11-03,Kill the Irishman,12000000,1188194,1188194,2011,-10811806,-90.09838333333333,2010
5167,2011-11-03,3 Backyards,300000,39475,39475,2011,-260525,-86.84166666666667,2010
559,2011-11-11,Jack and Jill,79000000,150519217,74158157,2011,71519217,90.53065443037974,2010
589,2011-11-11,Immortals,75000000,211562435,83504017,2011,136562435,182.08324666666667,2010
3503,2011-11-11,Melancholia,9400000,21817298,3030848,2011,12417298,132.09891489361704,2010
2322,2011-11-16,The Descendants,20000000,175507800,82624961,2011,155507800,777.539,2010
207,2011-11-18,Happy Feet Two,135000000,157956466,64006466,2011,22956466,17.00478962962963,2010
227,2011-11-18,"The Twilight Saga: Breaking Dawn, Part 1",127500000,689420051,281287133,2011,561920051,440.721608627451,2010
4232,2011-11-18,Another Happy Day,4000000,978527,9120,2011,-3021473,-75.536825,2010
78,2011-11-23,Hugo,180000000,180047784,73864507,2011,47784,0.026546666666666666,2010
464,2011-11-23,Arthur Christmas,85000000,149717124,46462469,2011,64717124,76.13779294117647,2010
1170,2011-11-23,The Muppets,45000000,160971922,88625922,2011,115971922,257.7153822222222,2010
2475,2011-11-23,A Dangerous Method,20000000,14807531,5702083,2011,-5192469,-25.962345,2010
3377,2011-11-23,My Week with Marilyn,10000000,34240572,14597405,2011,24240572,242.40572,2010
2731,2011-11-25,The Artist,16000000,128256712,44667095,2011,112256712,701.6044499999999,2010
1349,2011-12-08,Final Destination 5,40000000,155011165,42587643,2011,115011165,287.5279125,2010
1906,2011-12-08,30 Minutes or Less,28000000,40966716,37053924,2011,12966716,46.3097,2010
3531,2011-12-08,Glee: The 3D Concert Movie,9000000,17462398,11862398,2011,8462398,94.02664444444444,2010
173,2011-12-16,Mission: Impossible—Ghost Protocol,145000000,694713230,209397903,2011,549713230,379.1125724137931,2010
240,2011-12-16,Sherlock Holmes: A Game of Shadows,125000000,535663443,186848418,2011,410663443,328.53075440000003,2010
497,2011-12-16,Alvin and the Chipmunks: Chipwrecked,80000000,349088523,133107389,2011,269088523,336.36065375,2010
2141,2011-12-16,Carnage,25000000,38112154,2546747,2011,13112154,52.448616,2010
406,2011-12-20,The Girl with the Dragon Tattoo,90000000,239373970,102515793,2011,149373970,165.97107777777777,2010
223,2011-12-21,The Adventures of Tintin,130000000,373993951,77591831,2011,243993951,187.68765461538462,2010
3690,2011-12-21,Albert Nobbs,7500000,8539003,3014696,2011,1039003,13.853373333333332,2010
1029,2011-12-23,We Bought a Zoo,50000000,118729073,75624550,2011,68729073,137.458146,2010
3090,2011-12-23,In The Land of Blood and Honey,13000000,509193,303877,2011,-12490807,-96.08313076923078,2010
652,2011-12-25,War Horse,70000000,156815529,79883359,2011,86815529,124.02218428571427,2010
1368,2011-12-25,Extremely Loud and Incredibly Close,40000000,55247881,31847881,2011,15247881,38.1197025,2010
1632,2011-12-25,The Darkest Hour,34800000,62831715,21443494,2011,28031715,80.55090517241379,2010
4980,2011-12-30,Jodaeiye Nader az Simin,800000,24426169,7098492,2011,23626169,2953.2711249999998,2010
3225,2011-12-31,Tu Xia Chuan Qi,12000000,1828400,0,2011,-10171600,-84.76333333333334,2010
3508,2011-12-31,Red Dog,9100000,20927794,0,2011,11827794,129.97575824175826,2010
3819,2011-12-31,Tracker,6500000,3149,0,2011,-6496851,-99.95155384615386,2010
4464,2011-12-31,La Cara Oculta,2600000,7033931,0,2011,4433931,170.53580769230769,2010
5319,2011-12-31,Absentia,70000,8555,0,2011,-61445,-87.77857142857142,2010
102,2012-01-06,Snow White and the Huntsman,170000000,401021746,155136755,2012,231021746,135.89514470588236,2010
3189,2012-01-06,For Greater Glory,12000000,10026255,5669081,2012,-1973745,-16.447875,2010
4238,2012-01-06,The Loved Ones,4000000,12302,0,2012,-3987698,-99.69245,2010
4810,2012-01-06,"Pink Ribbons, Inc.",1200000,26608,26608,2012,-1173392,-97.78266666666666,2010
4905,2012-01-06,Hardflip,1000000,96734,96734,2012,-903266,-90.3266,2010
200,2012-01-10,The Croods,135000000,573068425,187168425,2012,438068425,324.4951296296296,2010
1932,2012-01-13,Joyful Noise,27500000,31157914,30932113,2012,3657914,13.301505454545454,2010
2031,2012-01-13,Contraband,25000000,98406855,66528000,2012,73406855,293.62742000000003,2010
2976,2012-01-13,The Iron Lady,14000000,115592104,29959436,2012,101592104,725.6578857142857,2010
3759,2012-01-13,We Need to Talk About Kevin,7000000,10765283,1738692,2012,3765283,53.78975714285714,2010
4412,2012-01-13,The Divide,3000000,156362,18000,2012,-2843638,-94.78793333333333,2010
5382,2012-01-13,Newlyweds,9000,4584,4584,2012,-4416,-49.06666666666666,2010
365,2012-01-20,Jin líng shí san chai,100000000,98227017,311434,2012,-1772983,-1.7729829999999998,2010
659,2012-01-20,Underworld: Awakening,70000000,160379930,62321039,2012,90379930,129.11418571428572,2010
886,2012-01-20,Red Tails,58000000,50365498,49876377,2012,-7634502,-13.16293448275862,2010
2209,2012-01-20,Haywire,23000000,36374700,18942396,2012,13374700,58.15086956521739,2010
3444,2012-01-20,Coriolanus,10000000,1049641,749641,2012,-8950359,-89.50359,2010
1261,2012-01-27,One for the Money,42000000,36197221,26414527,2012,-5802779,-13.816140476190474,2010
1266,2012-01-27,Man on a Ledge,42000000,45688337,18620000,2012,3688337,8.781754761904761,2010
2041,2012-01-27,The Grey,25000000,81249176,51580136,2012,56249176,224.996704,2010
698,2012-02-03,Doctor Seuss' The Lorax,67500000,350976753,214030500,2012,283476753,419.96556,2010
3137,2012-02-03,Project X,12000000,103028188,54731865,2012,91028188,758.5682333333334,2010
4403,2012-02-03,Tim and Eric's Billion Dollar Movie,3000000,223652,201436,2012,-2776348,-92.54493333333333,2010
111,2012-02-11,Wreck-It Ralph,165000000,496511521,189412677,2012,331511521,200.91607333333332,2010
1693,2012-02-11,Flight,31000000,160558438,93772375,2012,129558438,417.9304451612904,2010
2775,2012-02-11,Vamps,16000000,94812,3361,2012,-15905188,-99.407425,2010
2870,2012-02-11,The Man with the Iron Fists,15000000,22018988,15634090,2012,7018988,46.79325333333333,2010
732,2012-02-17,This Means War,65000000,156974557,54760791,2012,91974557,141.49931846153848,2010
898,2012-02-17,Ghost Rider: Spirit of Vengeance,57000000,149217355,51774002,2012,92217355,161.78483333333332,2010
2208,2012-02-17,Kari gurashi no Arietti,23000000,151496097,19192510,2012,128496097,558.6786826086956,2010
1661,2012-02-24,Wanderlust,32500000,24159934,17288155,2012,-8340066,-25.66174153846154,2010
2972,2012-02-24,Tyler Perry's Good Deeds,14000000,35579177,35025791,2012,21579177,154.13697857142856,2010
3131,2012-02-24,Act of Valor,12000000,82497035,70012847,2012,70497035,587.4752916666667,2010
1393,2012-03-02,Big Miracle,40000000,25268680,20157300,2012,-14731320,-36.828300000000006,2010
2812,2012-03-02,The Woman in Black,15000000,128955898,54333290,2012,113955898,759.7059866666667,2010
3134,2012-03-02,Chronicle,12000000,123681790,64575175,2012,111681790,930.6815833333334,2010
4991,2012-03-02,Kill List,800000,462206,29063,2012,-337794,-42.224250000000005,2010
4999,2012-03-02,The Innkeepers,750000,1011535,78396,2012,261535,34.87133333333333,2010
26,2012-03-07,The Amazing Spider-Man,220000000,757890267,262030663,2012,537890267,244.4955759090909,2010
249,2012-03-08,Total Recall,125000000,211856088,58877969,2012,86856088,69.4848704,2010
2243,2012-03-08,Diary of a Wimpy Kid: Dog Days,22000000,77229695,49008662,2012,55229695,251.0440681818182,2010
4976,2012-03-08,Celeste and Jesse Forever,840000,3787689,3103407,2012,2947689,350.91535714285715,2010
1247,2012-03-16,21 Jump Street,42000000,202812429,138447667,2012,160812429,382.88673571428575,2010
3415,2012-03-16,"Jeff, Who Lives at Home",10000000,4708127,4269426,2012,-5291873,-52.918730000000004,2010
3863,2012-03-16,Casa de mi Padre,6000000,8446952,5909483,2012,2446952,40.78253333333333,2010
4235,2012-03-20,A Lonely Place to Die,4000000,442550,0,2012,-3557450,-88.93625,2010
486,2012-03-23,The Hunger Games,80000000,677923379,408010692,2012,597923379,747.40422375,2010
4826,2012-03-23,Serbuan maut,1100000,9297407,4105123,2012,8197407,745.2188181818182,2010
4861,2012-03-23,October Baby,1000000,5391992,5355847,2012,4391992,439.1992,2010
163,2012-03-30,Wrath of the Titans,150000000,305270083,83670083,2012,155270083,103.51338866666666,2010
457,2012-03-30,Mirror Mirror,85000000,173613482,64935167,2012,88613482,104.25115529411764,2010
22,2012-04-05,The Avengers,225000000,1519479547,623279547,2012,1294479547,575.3242431111112,2010
3118,2012-04-05,A Little Bit of Heaven,12500000,1100287,10011,2012,-11399713,-91.197704,2010
3284,2012-04-05,LOL,11000000,10431506,0,2012,-568494,-5.168127272727273,2010
3318,2012-04-05,The Best Exotic Marigold Hotel,10000000,134639780,46383639,2012,124639780,1246.3978,2010
1766,2012-04-13,The Three Stooges,30000000,54052249,44338224,2012,24052249,80.17416333333334,2010
1773,2012-04-13,The Cabin in the Woods,30000000,70768144,42073277,2012,40768144,135.89381333333333,2010
2429,2012-04-13,Lockout,20000000,33943049,14326865,2012,13943049,69.71524500000001,2010
4806,2012-04-13,Blue Like Jazz,1200000,595018,595018,2012,-604982,-50.415166666666664,2010
4957,2012-04-13,L!fe Happens,930000,30905,30905,2012,-899095,-96.6768817204301,2010
2033,2012-04-20,The Lucky One,25000000,96633833,60457138,2012,71633833,286.535332,2010
3124,2012-04-20,Think Like a Man,12000000,113373764,91547205,2012,101373764,844.7813666666667,2010
3209,2012-04-20,Darling Companion,12000000,1200346,793352,2012,-10799654,-89.99711666666667,2010
954,2012-04-27,The Pirates! Band of Misfits,55000000,136143605,31051126,2012,81143605,147.53382727272728,2010
1651,2012-04-27,Safe,33000000,41495213,17142080,2012,8495213,25.743069696969695,2010
1796,2012-04-27,The Five-Year Engagement,30000000,61623819,28700285,2012,31623819,105.41273,2010
1991,2012-04-27,The Raven,26000000,30601801,16008272,2012,4601801,17.699234615384615,2010
3858,2012-04-27,Bernie,6000000,10106975,9204489,2012,4106975,68.44958333333334,2010
3946,2012-04-27,Hodejegerne,5250000,20188740,1200010,2012,14938740,284.5474285714286,2010
4965,2012-04-27,The Giant Mechanical Man,900000,7396,7396,2012,-892604,-99.17822222222222,2010
5282,2012-04-27,Sound of My Voice,135000,429448,408015,2012,294448,218.1096296296296,2010
3156,2012-05-07,Katy Perry: Part of Me,12000000,32700439,25326071,2012,20700439,172.50365833333333,2010
1161,2012-05-10,Taken 2,45000000,377807404,139854287,2012,332807404,739.572008888889,2010
1439,2012-05-10,Frankenweenie,39000000,81150788,35287788,2012,42150788,108.07894358974359,2010
3116,2012-05-10,The Paperboy,12500000,3522153,677200,2012,-8977847,-71.822776,2010
3658,2012-05-10,Wuthering Heights,8000000,2721534,100915,2012,-5278466,-65.980825,2010
3910,2012-05-10,Trade of Innocents,5800000,15091,15091,2012,-5784909,-99.73981034482759,2010
730,2012-05-16,The Dictator,65000000,180148897,59650222,2012,115148897,177.15214923076923,2010
34,2012-05-18,Battleship,209000000,305218228,65233400,2012,96218228,46.03742966507177,2010
1473,2012-05-18,What to Expect When You're Expecting,37500000,120925697,41152203,2012,83425697,222.46852533333333,2010
3561,2012-05-18,Polisse,8900000,22744132,176988,2012,13844132,155.55204494382022,2010
4829,2012-05-18,Beyond the Black Rainbow,1100000,56491,56491,2012,-1043509,-94.86445454545455,2010
29,2012-05-25,Men in Black 3,215000000,654213485,179020854,2012,439213485,204.2853418604651,2010
2730,2012-05-25,Moonrise Kingdom,16000000,68582095,45512466,2012,52582095,328.63809375,2010
3287,2012-05-25,Les Intouchables,10800000,484873045,13182281,2012,474073045,4389.5652314814815,2010
4847,2012-05-25,Chernobyl Diaries,1000000,42411721,18119640,2012,41411721,4141.1721,2010
1041,2012-06-04,American Reunion,50000000,236799211,56758835,2012,186799211,373.598422,2010
4393,2012-06-04,Damsels in Distress,3000000,1324299,1007535,2012,-1675701,-55.856700000000004,2010
1194,2012-06-07,Savages,45000000,80594860,47323100,2012,35594860,79.09968888888889,2010
668,2012-06-15,Rock of Ages,70000000,61031932,38518613,2012,-8968068,-12.811525714285715,2010
896,2012-06-15,That's My Boy,57500000,58085235,36931089,2012,585235,1.0178,2010
5287,2012-06-15,Your Sister's Sister,120000,3090593,1597486,2012,2970593,2475.494166666667,2010
69,2012-06-22,Brave,185000000,554606532,237282182,2012,369606532,199.7873145945946,2010
700,2012-06-22,Abraham Lincoln: Vampire Hunter,67500000,137489730,37519139,2012,69989730,103.68848888888888,2010
2283,2012-06-22,To Rome with Love,21500000,74326015,16684352,2012,52826015,245.70239534883723,2010
3399,2012-06-22,Seeking a Friend for the End of the World,10000000,11766959,7078738,2012,1766959,17.66959,2010
4663,2012-06-27,Beasts of the Southern Wild,1800000,23265132,12795746,2012,21465132,1192.5073333333335,2010
1003,2012-06-29,Ted,50000000,556016627,218665740,2012,506016627,1012.0332539999999,2010
2331,2012-06-29,Tyler Perry's Madea's Witness Protection,20000000,66950887,65653242,2012,46950887,234.75443500000003,2010
2756,2012-06-29,People Like Us,16000000,12519804,12431792,2012,-3480196,-21.751224999999998,2010
3710,2012-06-29,Magic Mike,7000000,170549753,113721571,2012,163549753,2336.4250428571427,2010
2484,2012-07-09,The Cold Light of Day,20000000,25361206,3763583,2012,5361206,26.806029999999996,2010
3857,2012-07-09,The Words,6000000,16369708,11494838,2012,10369708,172.82846666666666,2010
3913,2012-07-09,The Inbetweeners,5700000,86051320,35955,2012,80351320,1409.6722807017545,2010
4396,2012-07-09,Bachelorette,3000000,12577401,446770,2012,9577401,319.24670000000003,2010
3891,2012-07-12,Deadfall,6000000,1673635,66351,2012,-4326365,-72.10608333333333,2010
3919,2012-07-12,Khiladi 786,5600000,14683763,385422,2012,9083763,162.21005357142857,2010
371,2012-07-13,Ice Age: Continental Drift,95000000,879765137,161321843,2012,784765137,826.068565263158,2010
2655,2012-07-13,Red Lights,17700000,14518884,49521,2012,-3181116,-17.972406779661018,2010
4470,2012-07-13,2016: Obama’s America,2500000,33349941,33349941,2012,30849941,1233.99764,2010
5,2012-07-20,The Dark Knight Rises,275000000,1084439099,448139099,2012,809439099,294.3414905454545,2010
5225,2012-07-20,Burn,225000,1109276,1109276,2012,884276,393.01155555555556,2010
948,2012-07-27,The Watch,55000000,67130045,34353000,2012,12130045,22.054627272727274,2010
1647,2012-07-27,Step Up Revolution,33000000,165552290,35074677,2012,132552290,401.67360606060606,2010
3436,2012-07-27,Killer Joe,10000000,4659110,1291645,2012,-5340890,-53.4089,2010
172,2012-08-06,Madagascar 3: Europe's Most Wanted,145000000,746921271,216391482,2012,601921271,415.1181179310345,2010
246,2012-08-06,Prometheus,125000000,402448265,126477084,2012,277448265,221.95861200000002,2010
4998,2012-08-06,Safety Not Guaranteed,750000,4422318,4010957,2012,3672318,489.64239999999995,2010
1741,2012-08-08,Hope Springs,30000000,133085295,63536011,2012,103085295,343.61765,2010
45,2012-08-11,Skyfall,200000000,1110526981,304360277,2012,910526981,455.2634905,2010
1336,2012-08-15,The Odd Life of Timothy Green,40000000,55249159,51853450,2012,15249159,38.1228975,2010
343,2012-08-17,The Expendables 2,100000000,311979256,85028192,2012,211979256,211.979256,2010
820,2012-08-17,ParaNorman,60000000,108119662,56003051,2012,48119662,80.19943666666667,2010
3352,2012-08-17,Sparkle,10000000,24660323,24397469,2012,14660323,146.60323,2010
4094,2012-08-17,The Awakening,4900000,6924321,95933,2012,2024321,41.312673469387754,2010
4483,2012-08-17,Robot & Frank,2500000,4934356,3317468,2012,2434356,97.37424,2010
5184,2012-08-17,Compliance,270000,830700,319285,2012,560700,207.66666666666666,2010
2263,2012-08-22,Hit & Run,22000000,17216955,13749300,2012,-4783045,-21.741113636363636,2010
1586,2012-08-24,Premium Rush,35000000,31393201,20275446,2012,-3606799,-10.30514,2010
2151,2012-08-24,Les petits mouchoirs,25000000,48530887,205505,2012,23530887,94.123548,2010
2703,2012-08-24,The Apparition,17000000,10637281,4936819,2012,-6362719,-37.42775882352941,2010
4203,2012-08-24,Samsara,4000000,5966671,2672413,2012,1966671,49.166775,2010
1984,2012-08-29,Lawless,26000000,54393637,37397291,2012,28393637,109.20629615384615,2010
2495,2012-08-29,The Oogieloves in the BIG Balloon Adventure,20000000,1065907,1065907,2012,-18934093,-94.67046500000001,2010
2967,2012-08-31,The Possession,14000000,82925064,49130588,2012,68925064,492.32188571428577,2010
4970,2012-08-31,"For a Good Time, Call",850000,1386088,1251749,2012,536088,63.06917647058824,2010
7,2012-09-03,John Carter,275000000,282778100,73058679,2012,7778100,2.8284,2010
1395,2012-09-03,A Thousand Words,40000000,20790486,18450127,2012,-19209514,-48.023785000000004,2010
4551,2012-09-03,Silent House,2000000,16610760,12739737,2012,14610760,730.538,2010
708,2012-09-11,Lincoln,65000000,273346281,182207973,2012,208346281,320.53274,2010
2163,2012-09-11,Dangerous Liaisons,24200000,10447579,17000,2012,-13752421,-56.82818595041322,2010
5169,2012-09-11,Nothing But a Man,300000,17241,17241,2012,-282759,-94.253,2010
738,2012-09-14,Resident Evil: Retribution,65000000,238940997,42345531,2012,173940997,267.6015338461538,2010
1474,2012-09-14,The Master,37500000,58792011,16247159,2012,21292011,56.778696,2010
1627,2012-09-14,Stolen,35000000,17967746,289773,2012,-17032254,-48.663582857142856,2010
3184,2012-09-14,Arbitrage,12000000,35830713,7919574,2012,23830713,198.58927500000001,2010
4108,2012-09-14,Barfi,4600000,36751984,2804874,2012,32151984,698.9561739130435,2010
846,2012-09-21,Trouble with the Curve,60000000,47818913,35763137,2012,-12181087,-20.301811666666666,2010
1220,2012-09-21,Dredd,45000000,41467606,13414714,2012,-3532394,-7.849764444444444,2010
2822,2012-09-21,End of Watch,15000000,57586606,41003371,2012,42586606,283.91070666666667,2010
3062,2012-09-21,The Perks of Being a Wallflower,13000000,33069303,17742948,2012,20069303,154.37925384615386,2010
3789,2012-09-21,House at the End of the Street,6900000,44103982,31611916,2012,37203982,539.1881449275362,2010
447,2012-09-28,Hotel Transylvania,85000000,378505812,148313048,2012,293505812,345.30095529411767,2010
1735,2012-09-28,Looper,30000000,170466405,66486205,2012,140466405,468.22135,2010
2551,2012-09-28,Won't Back Down,19000000,5714913,5310554,2012,-13285087,-69.92151052631579,2010
2674,2012-09-28,Pitch Perfect,17000000,116044347,65001093,2012,99044347,582.613805882353,2010
5072,2012-09-28,The Other Dream Team,500000,314444,134109,2012,-185556,-37.1112,2010
449,2012-10-02,Safe House,85000000,208542162,126181630,2012,123542162,145.34372,2010
558,2012-10-02,Journey 2: The Mysterious Island,79000000,318146162,103860290,2012,239146162,302.71666075949366,2010
1709,2012-10-02,The Vow,30000000,197618160,125014030,2012,167618160,558.7271999999999,2010
247,2012-10-08,The Bourne Legacy,125000000,280355920,113203870,2012,155355920,124.28473600000001,2010
375,2012-10-08,The Campaign,95000000,104907746,86907746,2012,9907746,10.429206315789475,2010
4210,2012-10-17,Holy Motors,4000000,4230426,641054,2012,230426,5.76065,2010
1576,2012-10-19,Alex Cross,35000000,35426759,25888412,2012,426759,1.2193114285714286,2010
3963,2012-10-19,Paranormal Activity 4,5000000,140619520,53900335,2012,135619520,2712.3903999999998,2010
4612,2012-10-19,The First Time ,2000000,17061,17061,2012,-1982939,-99.14695,2010
4859,2012-10-19,The Sessions,1000000,11495204,6002451,2012,10495204,1049.5203999999999,2010
325,2012-10-26,Cloud Atlas,102000000,130673154,27108272,2012,28673154,28.110935294117645,2010
2415,2012-10-26,Silent Hill: Revelation 3D,20000000,55975672,17530219,2012,35975672,179.87836,2010
2473,2012-10-26,Chasing Mavericks,20000000,8300821,6002756,2012,-11699179,-58.495895,2010
2996,2012-10-26,Fun Size ,14000000,11166615,9409538,2012,-2833385,-20.238464285714286,2010
4073,2012-10-26,Mientras duermes,5000000,9109597,0,2012,4109597,82.19194,2010
4619,2012-10-26,The Ghastly Love of Johnny X,2000000,2436,2436,2012,-1997564,-99.87819999999999,2010
165,2012-11-05,Dark Shadows,150000000,238202668,79727149,2012,88202668,58.80177866666667,2010
4153,2012-11-07,Snabba Cash,4300000,10212403,188870,2012,5912403,137.49774418604653,2010
3505,2012-11-13,Jab Tak Hai Jaan,9200000,5806666,3047539,2012,-3393334,-36.8840652173913,2010
199,2012-11-16,"The Twilight Saga: Breaking Dawn, Part 2",136200000,829724737,292324737,2012,693524737,509.1958421439061,2010
1123,2012-11-16,Anna Karenina,49000000,71004627,12816367,2012,22004627,44.90740204081632,2010
2284,2012-11-16,Silver Linings Playbook,21000000,236412453,132092958,2012,215412453,1025.7735857142857,2010
3282,2012-11-16,Le prénom,11000000,25307405,61611,2012,14307405,130.0673181818182,2010
177,2012-11-21,Rise of the Guardians,145000000,306900902,103412758,2012,161900902,111.65579448275862,2010
258,2012-11-21,Life of Pi,120000000,607987022,124987022,2012,487987022,406.65585166666665,2010
735,2012-11-21,Red Dawn,65000000,48164150,44806783,2012,-16835850,-25.90130769230769,2010
2523,2012-11-23,De rouille et d’os,19500000,29393634,2061449,2012,9893634,50.736584615384615,2010
2872,2012-11-30,Killing Them Softly,15000000,39238443,14945541,2012,24238443,161.58962,2010
3403,2012-11-30,The Collection,10000000,8890094,6810754,2012,-1109906,-11.09906,2010
1231,2012-12-10,Argo,44500000,227140757,136025503,2012,182640757,410.42866741573033,2010
1255,2012-12-10,Here Comes the Boom,42000000,73239258,45290318,2012,31239258,74.37918571428571,2010
3022,2012-12-10,Seven Psychopaths,13500000,33035736,15024049,2012,19535736,144.70915555555555,2010
3418,2012-12-10,Atlas Shrugged: Part II,10000000,3336053,3336053,2012,-6663947,-66.63947,2010
4335,2012-12-10,Sinister,3000000,87727807,48086903,2012,84727807,2824.2602333333334,2010
5238,2012-12-10,Middle of Nowhere,200000,236806,236806,2012,36806,18.403,2010
13,2012-12-14,The Hobbit: An Unexpected Journey,250000000,1017003568,303003568,2012,767003568,306.80142720000003,2010
986,2012-12-19,Zero Dark Thirty,52500000,134612435,95720716,2012,82112435,156.4046380952381,2010
1358,2012-12-19,The Guilt Trip,40000000,41294674,37134215,2012,1294674,3.2366850000000005,2010
3493,2012-12-19,Amour,9700000,36787044,6738954,2012,27087044,279.24787628865977,2010
799,2012-12-21,Jack Reacher,60000000,217370736,80070736,2012,157370736,262.28456,2010
1394,2012-12-21,The Impossible,40000000,169590606,19019882,2012,129590606,323.976515,2010
1528,2012-12-21,This is 40,35000000,90221182,67544505,2012,55221182,157.7748057142857,2010
2115,2012-12-21,Cirque du Soleil: Worlds Away,25000000,28012862,12512862,2012,3012862,12.051447999999999,2010
331,2012-12-25,Django Unchained,100000000,449948323,162805434,2012,349948323,349.948323,2010
712,2012-12-25,Les Miserables,65000000,442169052,148809770,2012,377169052,580.2600799999999,2010
2025,2012-12-25,Parental Guidance,25000000,120832383,77267296,2012,95832383,383.329532,2010
566,2012-12-31,Astérix et Obélix: Au service de Sa Majesté ,77600000,60680125,0,2012,-16919875,-21.803962628865982,2010
1230,2012-12-31,Foodfight!,45000000,73706,0,2012,-44926294,-99.83620888888889,2010
2511,2012-12-31,Zambezia,20000000,34454631,0,2012,14454631,72.273155,2010
962,2013-01-02,Bullet to the Head,55000000,22597969,9489829,2013,-32402031,-58.91278363636364,2010
1736,2013-01-02,Warm Bodies,30000000,115121608,66380662,2013,85121608,283.73869333333334,2010
4720,2013-01-02,The Gatekeepers,1500000,2592308,2408553,2013,1092308,72.82053333333334,2010
58,2013-01-03,Jack the Giant Slayer,195000000,197687603,65187603,2013,2687603,1.3782579487179487,2010
2642,2013-01-03,Phantom,18000000,1199510,1034589,2013,-16800490,-93.33605555555555,2010
3055,2013-01-03,21 and Over,13000000,42195766,25682380,2013,29195766,224.5828153846154,2010
3117,2013-01-03,Ernest et Celestine,12500000,9376444,292562,2013,-3123556,-24.988447999999998,2010
3204,2013-01-03,Stoker,12000000,12079308,1703125,2013,79308,0.6609,2010
4140,2013-01-03,The Sweeney,4500000,7838405,26345,2013,3338405,74.18677777777778,2010
4175,2013-01-03,The Last Exorcism Part II,4000000,25448707,15179303,2013,21448707,536.217675,2010
4488,2013-01-03,The Lost Medallion: The Adventures of Billy Stone,2500000,549632,549632,2013,-1950368,-78.01472000000001,2010
4624,2013-01-04,Stitches,2000000,63555,0,2013,-1936445,-96.82225,2010
302,2013-01-11,Ender's Game,110000000,127983283,61737191,2013,17983283,16.348439090909093,2010
937,2013-01-11,Free Birds,55000000,110387072,55750480,2013,55387072,100.70376727272728,2010
3172,2013-01-11,About Time,12000000,89309178,15323921,2013,77309178,644.24315,2010
3975,2013-01-11,Dallas Buyers Club,5000000,60611845,27298285,2013,55611845,1112.2369,2010
1587,2013-01-18,Broken City,35000000,34480045,19701164,2013,-519955,-1.4855857142857143,2010
1829,2013-01-18,The Last Stand,30000000,48330757,12050299,2013,18330757,61.10252333333334,2010
2803,2013-01-18,Mama,15000000,148095566,71628180,2013,133095566,887.3037733333333,2010
1042,2013-01-25,Hansel & Gretel: Witch Hunters,50000000,214949716,55703475,2013,164949716,329.899432,2010
1594,2013-01-25,Parker,35000000,48543388,17616641,2013,13543388,38.695394285714286,2010
3391,2013-01-25,Movie 43,10000000,31164747,8840453,2013,21164747,211.64747,2010
5324,2013-01-25,Supporting Characters,60000,4917,4917,2013,-55083,-91.805,2010
1893,2013-01-28,Last Vegas,28000000,112914167,63914167,2013,84914167,303.2648821428571,2010
6,2013-02-07,The Lone Ranger,275000000,260002115,89302115,2013,-14997885,-5.453776363636364,2010
771,2013-02-08,2 Guns,61000000,132493015,75612460,2013,71493015,117.20166393442624,2010
4479,2013-02-08,The Spectacular Now,2500000,6916951,6852971,2013,4416951,176.67804,2010
5199,2013-02-08,The Canyons,250000,62375,59671,2013,-187625,-75.05,2010
391,2013-02-14,A Good Day to Die Hard,92000000,304249198,67349198,2013,212249198,230.70565,2010
1099,2013-02-14,Beautiful Creatures,50000000,60282876,19452138,2013,10282876,20.565752,2010
1887,2013-02-14,Safe Haven,28000000,94050951,71399120,2013,66050951,235.8962535714286,2010
1328,2013-02-15,Escape From Planet Earth,40000000,74156610,57012977,2013,34156610,85.391525,2010
2819,2013-02-22,Snitch,15000000,57907734,42930462,2013,42907734,286.05156,2010
4233,2013-02-22,Inescapable,4000000,4327,4327,2013,-3995673,-99.891825,2010
4271,2013-02-22,Dark Skies,3500000,27704111,17418667,2013,24204111,691.5460285714286,2010
3942,2013-02-26,Tao Jie,5400000,4728896,0,2013,-671104,-12.427851851851852,2010
41,2013-03-05,Iron Man 3,200000000,1215392272,408992272,2013,1015392272,507.696136,2010
3428,2013-03-05,The Iceman,10000000,3623609,1930282,2013,-6376391,-63.76391,2010
3455,2013-03-05,"Cinco de Mayo, La Batalla",10000000,173472,173472,2013,-9826528,-98.26528,2010
568,2013-03-07,Despicable Me 2,76000000,975216835,368065385,2013,899216835,1183.1800460526315,2010
4471,2013-03-07,Kevin Hart: Let Me Explain,2500000,32327255,32244051,2013,29827255,1193.0901999999999,2010
1117,2013-03-15,Upside Down,50000000,26387039,102118,2013,-23612961,-47.225922,2010
1679,2013-03-15,The Incredible Burt Wonderstone,32000000,27392609,22537881,2013,-4607391,-14.398096875,2010
3093,2013-03-15,The Call,12800000,69821476,51872378,2013,57021476,445.48028124999996,2010
4003,2013-03-15,Spring Breakers,5000000,31149251,14124286,2013,26149251,522.98502,2010
649,2013-03-22,Olympus Has Fallen,70000000,150562164,98927592,2013,80562164,115.08880571428573,2010
2150,2013-03-22,On the Road,25000000,9313302,720828,2013,-15686698,-62.746792,2010
3061,2013-03-22,Admission,13000000,18733666,18007317,2013,5733666,44.10512307692308,2010
187,2013-03-27,G.I. Joe: Retaliation,140000000,375740705,122523060,2013,235740705,168.38621785714284,2010
1083,2013-03-29,The Host,50000000,64477051,26623701,2013,14477051,28.954102,2010
2858,2013-03-29,The Place Beyond the Pines,15000000,47011449,21403519,2013,32011449,213.40966,2010
2366,2013-04-01,Texas Chainsaw 3D,20000000,47666013,34341945,2013,27666013,138.330065,2010
2903,2013-04-01,Promised Land,15000000,9300336,7597898,2013,-5699664,-37.99776,2010
282,2013-04-10,Gravity,110000000,695941797,274092705,2013,585941797,532.6743609090909,2010
1810,2013-04-10,Runner Runner,30000000,60512680,19316646,2013,30512680,101.70893333333333,2010
4688,2013-04-10,Grace Unplugged,1700000,2507159,2507159,2013,807159,47.47994117647059,2010
2266,2013-04-12,Out of the Furnace,22000000,15434375,11330849,2013,-6565625,-29.843750000000004,2010
1432,2013-04-16,Un monstre à Paris ,40000000,27000381,0,2013,-12999619,-32.4990475,2010
5071,2013-04-17,Deceptive Practice: The Mysteries and Mentors of Ricky Jay,500000,152449,152449,2013,-347551,-69.5102,2010
262,2013-04-19,Oblivion,120000000,287916633,89107235,2013,167916633,139.93052749999998,2010
4726,2013-04-19,The Lords of Salem,1500000,1541131,1165881,2013,41131,2.7420666666666667,2010
4787,2013-04-19,Filly Brown,1250000,2940411,2850357,2013,1690411,135.23288,2010
4801,2013-04-19,Home Run,1200000,2859955,2859955,2013,1659955,138.32958333333335,2010
1660,2013-04-26,The Big Wedding,32500000,48425971,21819348,2013,15925971,49.00298769230769,2010
1979,2013-04-26,Pain & Gain,26000000,81275291,49875291,2013,55275291,212.5972730769231,2010
2928,2013-04-26,The Reluctant Fundamentalist,15000000,528731,528731,2013,-14471269,-96.47512666666667,2010
3354,2013-04-26,Mud,10000000,31556959,21590086,2013,21556959,215.56959,2010
2676,2013-05-04,Evil Dead,17000000,97778356,54239856,2013,80778356,475.16679999999997,2010
2767,2013-05-04,Trance,16000000,22594052,2322593,2013,6594052,41.212824999999995,2010
4761,2013-05-04,Eddie: The Sleepwalking Cannibal,1400000,1632,1632,2013,-1398368,-99.88342857142857,2010
4966,2013-05-04,The Brass Teapot,900000,413733,6997,2013,-486267,-54.029666666666664,2010
3984,2013-05-07,The Way Way Back,5000000,26853810,21502690,2013,21853810,437.07620000000003,2010
60,2013-05-16,Star Trek Into Darkness,190000000,467381584,228778661,2013,277381584,145.99030736842104,2010
4301,2013-05-17,Jagten,3450000,18309793,687185,2013,14859793,430.7186376811594,2010
4377,2013-05-17,Frances Ha,3000000,11267511,4067398,2013,8267511,275.5837,2010
4418,2013-05-21,Open Road,3000000,47469,0,2013,-2952531,-98.4177,2010
320,2013-05-23,The Hangover 3,103000000,362000072,112200072,2013,259000072,251.45638058252428,2010
119,2013-05-24,Fast and Furious 6,160000000,789300444,238679850,2013,629300444,393.3127775,2010
339,2013-05-24,Epic,100000000,262794441,107518682,2013,162794441,162.794441,2010
4363,2013-05-24,Before Midnight,3000000,23283672,8110621,2013,20283672,676.1224000000001,2010
224,2013-05-31,After Earth,130000000,251499665,60522097,2013,121499665,93.46128076923077,2010
586,2013-05-31,Now You See Me,75000000,342769200,117723989,2013,267769200,357.0256,2010
3588,2013-05-31,Yeh Jawaani Hai Deewani,8300000,50827466,3827466,2013,42527466,512.3791084337349,2010
3814,2013-05-31,The East,6500000,3027956,2274649,2013,-3472044,-53.416061538461534,2010
1456,2013-06-09,Riddick,38000000,94763758,42025135,2013,56763758,149.37831052631577,2010
2936,2013-06-09,Winnie Mandela,15000000,61847,61847,2013,-14938153,-99.58768666666667,2010
2940,2013-06-12,Khumba,15000000,20898221,0,2013,5898221,39.32147333333334,2010
3266,2013-06-12,Inside Llewyn Davis,11000000,32943247,13248209,2013,21943247,199.48406363636363,2010
3293,2013-06-12,The Last Days on Mars,10600000,261364,24084,2013,-10338636,-97.53430188679245,2010
24,2013-06-14,Man of Steel,225000000,667999518,291045518,2013,442999518,196.88867466666667,2010
4863,2013-06-14,20 Feet From Stardom,1000000,5892466,4946250,2013,4892466,489.2466,2010
46,2013-06-21,Monsters University,200000000,743588329,268488329,2013,543588329,271.79416449999997,2010
61,2013-06-21,World War Z,190000000,531514650,202359711,2013,341514650,179.74455263157896,2010
166,2013-06-28,White House Down,150000000,205440387,73103784,2013,55440387,36.960258,2010
1239,2013-06-28,The Heat,43000000,229727774,159581587,2013,186727774,434.25063720930234,2010
2223,2013-06-28,Redemption,23000000,13593473,36686,2013,-9406527,-40.89794347826087,2010
5084,2013-06-28,Detention of the Dead,500000,1778,1778,2013,-498222,-99.6444,2010
888,2013-07-06,The Internship,58000000,93672764,44672764,2013,35672764,61.50476551724138,2010
4333,2013-07-06,The Purge,3000000,91266581,64473115,2013,88266581,2942.2193666666667,2010
419,2013-07-08,Percy Jackson: Sea of Monsters,90000000,200859554,68559554,2013,110859554,123.17728222222222,2010
1477,2013-07-08,We're the Millers,37000000,267816276,150394119,2013,230816276,623.827772972973,2010
205,2013-07-17,Turbo,135000000,286896578,83028130,2013,151896578,112.51598370370371,2010
226,2013-07-19,R.I.P.D.,130000000,79076678,33618855,2013,-50923322,-39.171786153846156,2010
477,2013-07-19,RED 2,84000000,137162560,53262560,2013,53162560,63.288761904761905,2010
2312,2013-07-19,The Conjuring,20000000,318000141,137400141,2013,298000141,1490.000705,2010
3944,2013-07-19,Grabbers,5300000,440821,0,2013,-4859179,-91.68262264150944,2010
4098,2013-07-19,Only God Forgives,4800000,4494560,775849,2013,-305440,-6.363333333333333,2010
4889,2013-07-19,The Act of Killing,1000000,501289,486919,2013,-498711,-49.8711,2010
3782,2013-07-23,Twixt,7000000,1268346,0,2013,-5731654,-81.88077142857144,2010
276,2013-07-26,The Wolverine,115000000,416456852,132556852,2013,301456852,262.1363930434783,2010
2589,2013-07-26,Blue Jasmine,18000000,102912961,33404871,2013,84912961,471.7386722222222,2010
4658,2013-07-26,Stranded,1900000,285593,0,2013,-1614407,-84.96878947368421,2010
4719,2013-07-26,The To Do List,1500000,4128828,3491669,2013,2628828,175.2552,2010
299,2013-07-31,The Smurfs 2,110000000,348547523,71017784,2013,238547523,216.86138454545457,2010
5086,2013-08-01,Now is Good,500000,2141436,0,2013,1641436,328.2872,2010
1515,2013-08-02,Identity Thief,35000000,175361578,134506920,2013,140361578,401.03308000000004,2010
1792,2013-08-02,Side Effects,30000000,66742138,32172757,2013,36742138,122.47379333333332,2010
4656,2013-08-02,ABCD (Any Body Can Dance),1900000,10137234,222098,2013,8237234,433.53863157894733,2010
47,2013-08-03,Oz the Great and Powerful,200000000,490359051,234770996,2013,290359051,145.17952549999998,2010
1833,2013-08-03,Dead Man Down,30000000,19599974,10895295,2013,-10400026,-34.66675333333333,2010
145,2013-08-11,Thor: The Dark World,150000000,644602516,206362140,2013,494602516,329.7350106666667,2010
2543,2013-08-11,The Book Thief,19000000,76086711,21488481,2013,57086711,300.4563736842105,2010
1413,2013-08-16,Paranoia,40000000,16173593,7388654,2013,-23826407,-59.5660175,2010
1712,2013-08-16,Lee Daniels' The Butler,30000000,177025498,116632095,2013,147025498,490.08499333333333,2010
1911,2013-08-16,Kick-Ass 2,28000000,63129909,28795985,2013,35129909,125.46396071428572,2010
2610,2013-08-16,Jobs,18000000,43402515,16131410,2013,25402515,141.12508333333332,2010
4056,2013-08-16,Ain't Them Bodies Saints,5000000,1075009,391611,2013,-3924991,-78.49982,2010
4498,2013-08-16,Underdogs,2500000,35017,35017,2013,-2464983,-98.59932,2010
853,2013-08-21,The Mortal Instruments: City of Bones,60000000,75965567,31165421,2013,15965567,26.609278333333336,2010
1443,2013-08-23,Yi dai zong shi,38600000,57987299,6594959,2013,19387299,50.22616321243524,2010
2387,2013-08-23,The World's End,20000000,47508505,26004851,2013,27508505,137.54252499999998,2010
2525,2013-08-23,The Frozen Ground,19200000,5617460,0,2013,-13582540,-70.74239583333333,2010
5064,2013-08-23,Drinking Buddies,500000,407100,343706,2013,-92900,-18.58,2010
5263,2013-08-23,Sparrows Dance,175000,2602,2602,2013,-172398,-98.51314285714285,2010
2619,2013-08-30,Getaway,18000000,11813989,10501938,2013,-6186011,-34.366727777777776,2010
3344,2013-08-30,One Direction: This is Us,10000000,68541786,28873374,2013,58541786,585.41786,2010
3966,2013-08-30,No se Aceptan Devoluciones,5000000,100486616,44467206,2013,95486616,1909.73232,2010
261,2013-09-08,Elysium,120000000,286192091,93050117,2013,166192091,138.49340916666665,2010
1021,2013-09-08,Disney Planes,50000000,238059569,90282580,2013,188059569,376.119138,2010
1784,2013-09-13,The Family,30000000,51078541,36918811,2013,21078541,70.26180333333333,2010
3958,2013-09-13,Insidious Chapter 2,5000000,161921515,83586447,2013,156921515,3138.4303,2010
4618,2013-09-13,Plush,2000000,28864,3080,2013,-1971136,-98.5568,2010
3620,2013-09-18,Enough Said,8000000,25621449,17550872,2013,17621449,220.26811249999997,2010
1156,2013-09-20,Prisoners,46000000,113402302,61002302,2013,67402302,146.52674347826087,2010
1461,2013-09-20,Rush,38000000,98230839,26947624,2013,60230839,158.50220789473684,2010
2457,2013-09-20,Battle of the Year,20000000,16723377,8888355,2013,-3276623,-16.383115,2010
3665,2013-09-20,Feichang Xingyun,8000000,21970000,0,2013,13970000,174.625,2010
561,2013-09-27,Cloudy with a Chance of Meatballs 2,78000000,274392649,119793567,2013,196392649,251.78544743589742,2010
2636,2013-09-27,Metallica Through the Never,18000000,9082906,3419967,2013,-8917094,-49.53941111111111,2010
3574,2013-09-27,Baggage Claim,8500000,22885836,21569509,2013,14385836,169.2451294117647,2010
3925,2013-09-27,Don Jon,5500000,41268579,24477704,2013,35768579,650.3378,2010
62,2013-10-05,The Great Gatsby,190000000,351040419,144840419,2013,161040419,84.75811526315789,2010
2894,2013-10-05,Peeples,15000000,9307166,9177065,2013,-5692834,-37.95222666666667,2010
675,2013-10-18,Escape Plan,70000000,103735965,25135965,2013,33735965,48.19423571428572,2010
1787,2013-10-18,Carrie,30000000,82409520,35266619,2013,52409520,174.69840000000002,2010
1996,2013-10-18,The Fifth Estate,26000000,6154172,3254172,2013,-19845828,-76.33010769230769,2010
2334,2013-10-18,12 Years a Slave,20000000,181025343,56671993,2013,161025343,805.1267149999999,2010
3579,2013-10-18,All is Lost,8500000,10386814,6263670,2013,1886814,22.197811764705882,2010
2098,2013-10-25,The Counselor,25000000,71009334,16973715,2013,46009334,184.037336,2010
2797,2013-10-25,Jackass Presents: Bad Grandpa,15000000,160903019,102003019,2013,145903019,972.6867933333333,2010
833,2013-11-01,Gangster Squad,60000000,104100903,46000903,2013,44100903,73.501505,2010
3262,2013-11-01,Quartet,11000000,56178935,18388357,2013,45178935,410.7175909090909,2010
4469,2013-11-01,A Haunted House,2500000,59922558,40041683,2013,57422558,2296.9023199999997,2010
915,2013-11-10,Captain Phillips,55000000,220648184,107136417,2013,165648184,301.1785163636364,2010
2464,2013-11-10,Machete Kills,20000000,18273009,8008161,2013,-1726991,-8.634955,2010
3945,2013-11-10,La Vie d'Adèle – Chapitres 1 & 2,5250000,22937201,2450504,2013,17687201,336.89906666666667,2010
5004,2013-11-10,All the Boys Love Mandy Lane,750000,1960521,0,2013,1210521,161.4028,2010
5020,2013-11-10,Escape from Tomorrow,650000,171962,171962,2013,-478038,-73.5443076923077,2010
2672,2013-11-15,The Best Man Holiday,17000000,72835710,70525195,2013,55835710,328.44535294117645,2010
3168,2013-11-15,Nebraska,12000000,24761360,17654912,2013,12761360,106.34466666666667,2010
3198,2013-11-15,La grande bellezza,12000000,29549145,2883879,2013,17549145,146.242875,2010
3761,2013-11-15,The Christmas Candle,7000000,1933829,1632000,2013,-5066171,-72.37387142857142,2010
134,2013-11-22,Frozen,150000000,1274234980,400738009,2013,1124234980,749.4899866666667,2010
211,2013-11-22,The Hunger Games: Catching Fire,130000000,864868047,424668047,2013,734868047,565.2831130769231,2010
2247,2013-11-22,Delivery Man,22000000,70536870,30659817,2013,48536870,220.62213636363634,2010
3142,2013-11-22,Philomena,12000000,98963392,37709979,2013,86963392,724.6949333333333,2010
2255,2013-11-27,Homefront,22000000,51695362,20158492,2013,29695362,134.9789181818182,2010
2663,2013-11-27,Black Nativity,17500000,7285135,7018188,2013,-10214865,-58.37065714285714,2010
1611,2013-11-29,Mandela: Long Walk to Freedom,35000000,29890402,8323085,2013,-5109598,-14.59885142857143,2010
1292,2013-12-04,42,40000000,97470701,95020213,2013,57470701,143.6767525,2010
2372,2013-12-04,Scary Movie V,20000000,78613981,32015787,2013,58613981,293.069905,2010
4329,2013-12-04,Antiviral,3100000,123407,0,2013,-2976593,-96.01912903225806,2010
1664,2013-12-06,This is the End,32000000,126539117,101470202,2013,94539117,295.434740625,2010
64,2013-12-07,Pacific Rim,190000000,411002906,101802906,2013,221002906,116.31731894736843,2010
496,2013-12-07,Grown Ups 2,80000000,247023808,133668525,2013,167023808,208.77976,2010
4960,2013-12-07,Fruitvale Station,900000,17549645,16098998,2013,16649645,1849.9605555555554,2010
15,2013-12-13,The Hobbit: The Desolation of Smaug,250000000,960366855,258366855,2013,710366855,284.14674199999996,2010
1281,2013-12-13,American Hustle,40000000,257878294,150117807,2013,217878294,544.695735,2010
1520,2013-12-13,Saving Mr. Banks,35000000,114962525,83299761,2013,79962525,228.46435714285715,2010
2039,2013-12-13,Tyler Perry's A Madea Christmas,25000000,52543354,52543354,2013,27543354,110.17341599999999,2010
1012,2013-12-18,Anchorman 2: The Legend Continues,50000000,172185754,127352707,2013,122185754,244.371508,2010
539,2013-12-20,Walking with Dinosaurs,80000000,130580730,36076121,2013,50580730,63.22591250000001,2010
95,2013-12-25,47 Ronin,175000000,151716815,38362475,2013,-23283185,-13.304677142857143,2010
338,2013-12-25,The Wolf of Wall Street,100000000,391976723,116900694,2013,291976723,291.976723,2010
394,2013-12-25,The Secret Life of Walter Mitty,91000000,188536838,58236838,2013,97536838,107.18333846153847,2010
1373,2013-12-25,Grudge Match,40000000,69807260,29807260,2013,29807260,74.51815,2010
2059,2013-12-25,August: Osage County,25000000,50738810,37738810,2013,25738810,102.95524,2010
1860,2013-12-31,Space Pirate Captain Harlock,30000000,143490,0,2013,-29856510,-99.5217,2010
2276,2013-12-31,Metegol,22000000,30051905,0,2013,8051905,36.599568181818185,2010
2778,2013-12-31,Zulu,16000000,1844228,0,2013,-14155772,-88.47357500000001,2010
4234,2013-12-31,Geograf globus propil,4000000,4454853,0,2013,454853,11.371325,2010
4924,2013-12-31,Heli,1000000,552614,0,2013,-447386,-44.7386,2010
5276,2013-12-31,Speak No Evil,150000,32927,0,2013,-117073,-78.04866666666666,2010
97,2014-01-08,Guardians of the Galaxy,170000000,771100771,333172112,2014,601100771,353.5886888235294,2010
1795,2014-01-08,Get on Up,30000000,33339868,30569935,2014,3339868,11.132893333333334,2010
2772,2014-01-10,"Men, Women and Children",16000000,1705908,705908,2014,-14294092,-89.33807499999999,2010
827,2014-01-17,Jack Ryan: Shadow Recruit,60000000,131377412,50577412,2014,71377412,118.96235333333334,2010
1738,2014-01-17,The Nut Job,30000000,122529966,64251538,2014,92529966,308.43322,2010
2013,2014-01-17,Ride Along,25000000,153733800,134202565,2014,128733800,514.9352,2010
3731,2014-01-17,Devil's Due,7000000,36146087,15821461,2014,29146087,416.37267142857144,2010
748,2014-01-24,"I, Frankenstein",65000000,74575290,19075290,2014,9575290,14.731215384615384,2010
3778,2014-01-28,Snezhnaya koroleva,7000000,15206330,0,2014,8206330,117.2332857142857,2010
2618,2014-01-31,Labor Day,18000000,14189810,13371528,2014,-3810190,-21.16772222222222,2010
3610,2014-01-31,That Awkward Moment,8000000,53068955,26068955,2014,45068955,563.3619375000001,2010
3768,2014-02-04,Dom Hemingway,7000000,1857458,523511,2014,-5142542,-73.46488571428571,2010
49,2014-02-05,The Amazing Spider-Man 2,200000000,708996336,202853933,2014,508996336,254.498168,2010
4460,2014-02-05,Ida,2600000,15298355,3827060,2014,12698355,488.39826923076924,2010
5031,2014-02-05,Water & Power,600000,42557,42557,2014,-557443,-92.90716666666667,2010
1794,2014-02-07,Deliver Us from Evil,30000000,87956618,30577122,2014,57956618,193.18872666666667,2010
2320,2014-02-07,Tammy,20000000,93931360,84525432,2014,73931360,369.65680000000003,2010
3047,2014-02-07,Earth to Echo,13000000,42174545,38934842,2014,29174545,224.41957692307693,2010
870,2014-02-14,Winter's Tale,60000000,22468620,12600231,2014,-37531380,-62.5523,2010
2392,2014-02-14,Endless Love,20000000,34718173,23438250,2014,14718173,73.59086500000001,2010
3043,2014-02-14,About Last Night,13000000,50445860,48637684,2014,37445860,288.0450769230769,2010
543,2014-02-21,Pompeii,80000000,108469033,23169033,2014,28469033,35.58629125,2010
1910,2014-02-21,3 Days to Kill,28000000,38959900,30697999,2014,10959900,39.142500000000005,2010
1019,2014-02-28,Non-Stop,50000000,222383055,91742160,2014,172383055,344.76610999999997,2010
2237,2014-02-28,Son of God,22000000,70949793,59700064,2014,48949793,222.4990590909091,2010
4687,2014-02-28,The Lunchbox,1700000,12231500,4231500,2014,10531500,619.5,2010
3972,2014-03-01,Paranormal Activity: The Marked Ones,5000000,86362372,32462372,2014,81362372,1627.24744,2010
768,2014-03-10,Gone Girl,61000000,368567189,167767189,2014,307567189,504.20850655737706,2010
2753,2014-03-10,Left Behind,16000000,20769209,14019924,2014,4769209,29.80755625,2010
3800,2014-03-10,Annabelle,6500000,256873813,84273813,2014,250373813,3851.9048153846156,2010
4759,2014-03-10,La chambre bleue,1400000,1945420,260441,2014,545420,38.95857142857143,2010
2826,2014-03-12,Wild,15000000,52501541,37880356,2014,37501541,250.01027333333332,2010
705,2014-03-14,Need for Speed,66000000,194169619,43568507,2014,128169619,194.19639242424242,2010
3395,2014-03-14,Bad Words,10000000,7843145,7779614,2014,-2156855,-21.568550000000002,2010
3873,2014-03-14,Veronica Mars,6000000,3485383,3322127,2014,-2514617,-41.91028333333333,2010
5248,2014-03-14,The Word,200000,3648,3648,2014,-196352,-98.176,2010
446,2014-03-21,Divergent,85000000,276014965,150947895,2014,191014965,224.7234882352941,2010
941,2014-03-21,Muppets Most Wanted,55000000,79312301,51178893,2014,24312301,44.20418363636364,2010
1998,2014-03-21,Blood Ties,26000000,2923959,42472,2014,-23076041,-88.75400384615385,2010
3438,2014-03-21,50 to 1,10000000,1069454,1069454,2014,-8930546,-89.30546,2010
4822,2014-03-21,God’s Not Dead,1150000,63777092,60755732,2014,62627092,5445.834086956522,2010
5303,2014-03-21,Cheap Thrills,100000,59424,59424,2014,-40576,-40.576,2010
222,2014-03-28,Noah,130000000,352831065,101200044,2014,222831065,171.40851153846154,2010
1605,2014-03-28,Sabotage,35000000,18376443,10508518,2014,-16623557,-47.49587714285714,2010
5173,2014-03-28,Locker 13,300000,3496,3496,2014,-296504,-98.83466666666666,2010
99,2014-04-04,Captain America: The Winter Soldier,170000000,714401889,259746958,2014,544401889,320.2364052941177,2010
3028,2014-04-04,Under the Skin,13300000,7229933,2614251,2014,-6070067,-45.639601503759394,2010
4141,2014-04-09,Falcon Rising,4500000,11774,11774,2014,-4488226,-99.73835555555556,2010
3125,2014-04-16,Heaven is for Real,12000000,100919111,91386097,2014,88919111,740.9925916666666,2010
362,2014-04-18,Transcendence,100000000,103039258,23022309,2014,3039258,3.039258,2010
4174,2014-04-18,A Haunted House 2,4000000,21206861,17329487,2014,17206861,430.171525,2010
1303,2014-04-25,The Other Woman,40000000,195111193,83911193,2014,155111193,387.7779825,2010
1915,2014-04-25,Brick Mansions,28000000,73421224,20396829,2014,45421224,162.21865714285715,2010
5123,2014-04-25,Blue Ruin,420000,435168,258384,2014,15168,3.6114285714285717,2010
1641,2014-05-09,Thunder and the House of Magic,34000000,10392666,4091,2014,-23607334,-69.43333529411765,2010
4519,2014-05-09,Frontera,2300000,59696,59696,2014,-2240304,-97.40452173913043,2010
112,2014-05-11,Interstellar,165000000,668913307,188017894,2014,503913307,305.40200424242425,2010
120,2014-05-16,Godzilla,160000000,529076069,200676069,2014,369076069,230.67254312499998,2010
2061,2014-05-16,Million Dollar Arm,25000000,39217912,36447959,2014,14217912,56.87164799999999,2010
2768,2014-05-16,The Immigrant,16000000,7585011,2013456,2014,-8414989,-52.59368125,2010
48,2014-05-23,X-Men: Days of Future Past,200000000,747862775,233921534,2014,547862775,273.9313875,2010
1196,2014-05-23,Blended,45000000,127990741,46290741,2014,82990741,184.42386888888888,2010
73,2014-05-30,Maleficent,180000000,758536735,241407328,2014,578536735,321.4092972222222,2010
1348,2014-05-30,A Million Ways to Die in The West,40000000,86778557,42720965,2014,46778557,116.9463925,2010
1237,2014-06-02,The Interview,44000000,12342632,6105175,2014,-31657368,-71.94856363636364,2010
82,2014-06-06,Edge of Tomorrow,178000000,370541256,100206256,2014,192541256,108.16924494382023,2010
3122,2014-06-06,The Fault in Our Stars,12000000,307166834,124872350,2014,295166834,2459.7236166666667,2010
4149,2014-06-06,Anna,4357373,1200000,0,2014,-3157373,-72.46047102233388,2010
4866,2014-06-06,Obvious Child,1000000,3324070,3122616,2014,2324070,232.40699999999998,2010
5203,2014-06-06,Test,250000,18823,18823,2014,-231177,-92.4708,2010
174,2014-06-13,How to Train Your Dragon 2,145000000,616102924,177002924,2014,471102924,324.89856827586203,2010
1004,2014-06-13,22 Jump Street,50000000,331333876,191719337,2014,281333876,562.6677520000001,2010
3583,2014-06-13,The Rover,8500000,3180252,1109199,2014,-5319748,-62.585270588235296,2010
4778,2014-06-13,Los insolitos peces gato,1300000,16653,11278,2014,-1283347,-98.719,2010
3557,2014-06-17,Beneath Hill 60,9000000,3440939,0,2014,-5559061,-61.76734444444445,2010
5304,2014-06-19,The Past is a Grotesque Animal,100000,20056,20056,2014,-79944,-79.944,2010
1343,2014-06-20,Jersey Boys,40000000,65282732,47047013,2014,25282732,63.206830000000004,2010
2168,2014-06-20,Think Like a Man Too,24000000,70027933,65028687,2014,46027933,191.7830541666667,2010
31,2014-06-27,Transformers: Age of Extinction,210000000,1104039076,245439076,2014,894039076,425.7328933333333,2010
1420,2014-06-27,Snowpiercer,40000000,88069880,4563029,2014,48069880,120.17469999999999,2010
3623,2014-06-27,Begin Again,8000000,68838736,16170632,2014,60838736,760.4842,2010
4417,2014-06-27,They Came Together,3000000,82780,0,2014,-2917220,-97.24066666666667,2010
654,2014-07-02,The Monuments Men,70000000,158702748,78031620,2014,88702748,126.71821142857142,2010
774,2014-07-02,The Lego Movie,60000000,457729388,257784718,2014,397729388,662.8823133333333,2010
176,2014-07-03,Mr. Peabody & Sherman,145000000,269806430,111506430,2014,124806430,86.0734,2010
292,2014-07-03,300: Rise of an Empire,110000000,330780051,106580051,2014,220780051,200.70913727272725,2010
1697,2014-07-03,The Grand Budapest Hotel,31000000,164350409,59076019,2014,133350409,430.16260967741937,2010
4213,2014-07-03,The Face of Love,4000000,1158877,385069,2014,-2841123,-71.028075,2010
109,2014-07-11,Big Hero 6,165000000,652127828,222527828,2014,487127828,295.2289866666667,2010
2828,2014-07-11,The Theory of Everything,15000000,123327692,35893537,2014,108327692,722.1846133333333,2010
3467,2014-07-11,Elsa & Fred,10000000,109144,67657,2014,-9890856,-98.90856,2010
1039,2014-07-18,Planes: Fire and Rescue,50000000,156399644,59157732,2014,106399644,212.799288,2010
1353,2014-07-18,Sex Tape,40000000,126069509,38543473,2014,86069509,215.17377249999998,2010
3513,2014-07-18,The Purge: Anarchy,9000000,111534881,71562550,2014,102534881,1139.2764555555555,2010
3871,2014-07-18,Wish I Was Here,6000000,6591365,3591299,2014,591365,9.856083333333334,2010
4893,2014-07-18,I Origins,1000000,852399,336472,2014,-147601,-14.760100000000001,2010
346,2014-07-25,Hercules,100000000,243388614,72688614,2014,143388614,143.388614,2010
1283,2014-07-25,Lucy,40000000,457507776,126573960,2014,417507776,1043.76944,2010
2613,2014-07-25,And So It Goes,18000000,17360801,15160801,2014,-639199,-3.551105555555555,2010
2867,2014-07-25,A Most Wanted Man,15000000,36068890,17237855,2014,21068890,140.45926666666665,2010
5317,2014-07-25,Happy Christmas,70000,30312,30312,2014,-39688,-56.69714285714286,2010
239,2014-08-08,Teenage Mutant Ninja Turtles,125000000,485004754,191204754,2014,360004754,288.0038032,2010
1054,2014-08-08,Into the Storm,50000000,156602194,47602194,2014,106602194,213.204388,2010
2239,2014-08-08,The Hundred-Foot Journey,22000000,94270488,54235441,2014,72270488,328.5022181818182,2010
2668,2014-08-13,Let’s Be Cops,17000000,136890774,82390774,2014,119890774,705.2398470588236,2010
357,2014-08-15,The Expendables 3,100000000,209461378,39322544,2014,109461378,109.461378,2010
2047,2014-08-15,The Giver,25000000,55090374,45090374,2014,30090374,120.36149599999999,2010
4408,2014-08-15,Fort McCoy,3000000,78948,78948,2014,-2921052,-97.3684,2010
5205,2014-08-15,Night Lights,250000,12848,12848,2014,-237152,-94.8608,2010
750,2014-08-22,Sin City: A Dame to Kill For,65000000,39499349,13757804,2014,-25500651,-39.231770769230764,2010
2842,2014-08-22,When the Game Stands Tall,15000000,30138912,30127963,2014,15138912,100.92608000000001,2010
3247,2014-08-22,If I Stay,11000000,78356170,50474843,2014,67356170,612.3288181818182,2010
2852,2014-08-27,The November Man,15000000,34820335,25018119,2014,19820335,132.13556666666665,2010
3985,2014-08-29,"As Above, So Below",5000000,41824066,21222315,2014,36824066,736.4813200000001,2010
5000,2014-08-29,Il conformista,750000,59656,59656,2014,-690344,-92.04586666666667,2010
683,2014-09-05,Legends of Oz: Dorothy’s Return,70000000,20107933,8462347,2014,-49892067,-71.27438142857143,2010
2564,2014-09-05,Neighbors,18000000,270944428,150086800,2014,252944428,1405.2468222222221,2010
4019,2014-09-05,Moms’ Night Out,5000000,10537341,10429707,2014,5537341,110.74682,2010
4881,2014-09-05,Palo Alto,1000000,1156309,767732,2014,156309,15.6309,2010
1633,2014-09-19,The Maze Runner,34000000,348319861,102427862,2014,314319861,924.4701794117648,2010
1913,2014-09-19,A Walk Among the Tombstones,28000000,62108587,26017685,2014,34108587,121.81638214285715,2010
2368,2014-09-19,This is Where I Leave You,20000000,41296320,34296320,2014,21296320,106.4816,2010
4391,2014-09-19,Tusk,3000000,1821983,1821983,2014,-1178017,-39.26723333333334,2010
4603,2014-09-19,Pump,2000000,72277,72277,2014,-1927723,-96.38615,2010
4990,2014-09-19,Not Cool,800000,35688,35688,2014,-764312,-95.539,2010
825,2014-09-26,The Boxtrolls,60000000,111946251,50837305,2014,51946251,86.577085,2010
918,2014-09-26,The Equalizer,55000000,192903624,101530738,2014,137903624,250.7338618181818,2010
3481,2014-09-26,Plastic,10000000,552641,0,2014,-9447359,-94.47359,2010
4058,2014-09-26,Jimi: All is By My Side,5000000,927074,340911,2014,-4072926,-81.45852000000001,2010
4703,2014-09-26,Two Night Stand,1600000,242443,15600,2014,-1357557,-84.8473125,2010
680,2014-10-01,The Legend of Hercules,70000000,58953319,18848538,2014,-11046681,-15.780972857142858,2010
1284,2014-10-01,Lone Survivor,40000000,149804632,125095601,2014,109804632,274.51158000000004,2010
2206,2014-10-01,Her,23000000,48531242,25568251,2014,25531242,111.00540000000001,2010
4953,2014-10-01,Banshee Chapter,950000,78122,0,2014,-871878,-91.77663157894736,2010
5083,2014-10-09,Born to Fly: Elizabeth Streb vs. Gravity,500000,1822,1822,2014,-498178,-99.6356,2010
660,2014-10-10,Dracula Untold,70000000,220241723,55991880,2014,150241723,214.63103285714286,2010
1055,2014-10-10,The Judge,50000000,76119388,47119388,2014,26119388,52.238776,2010
1891,2014-10-10,"Alexander and the Terrible, Horrible, No Good, Very Bad Day",28000000,101379287,66954149,2014,73379287,262.06888214285715,2010
2945,2014-10-10,Automata,15000000,29050,0,2014,-14970950,-99.80633333333333,2010
3046,2014-10-10,St. Vincent,13000000,54837234,44137712,2014,41837234,321.82487692307694,2010
3996,2014-10-10,Addicted,5000000,17499242,17390770,2014,12499242,249.98484,2010
4045,2014-10-10,Kill the Messenger,5000000,6656705,2450846,2014,1656705,33.1341,2010
4311,2014-10-10,Whiplash,3300000,33474334,13092006,2014,30174334,914.3737575757576,2010
4563,2014-10-10,Meet the Mormons,2000000,6049171,6047363,2014,4049171,202.45855,2010
2068,2014-10-12,The Gambler,25000000,38718031,33680992,2014,13718031,54.872124,2010
516,2014-10-17,Fury,80000000,210253368,85755593,2014,130253368,162.81671,2010
1049,2014-10-17,The Book of Life,50000000,97651543,50151543,2014,47651543,95.30308600000001,2010
1988,2014-10-17,The Best of Me,26000000,41059418,26766213,2014,15059418,57.92083846153846,2010
2585,2014-10-17,Birdman or (The Unexpected Virtue of Ignorance),18000000,103215094,42340598,2014,85215094,473.41718888888886,2010
4069,2014-10-17,Rudderless,5000000,567219,56001,2014,-4432781,-88.65562,2010
4746,2014-10-17,Housebound,1500000,236863,0,2014,-1263137,-84.20913333333333,2010
4916,2014-10-17,Camp X-Ray,1000000,9837,9837,2014,-990163,-99.0163,2010
1768,2014-10-24,John Wick,30000000,76235001,43037835,2014,46235001,154.11667,2010
3964,2014-10-24,Ouija,5000000,103683342,50856010,2014,98683342,1973.6668399999999,2010
4887,2014-10-24,23 Blast,1000000,549185,549185,2014,-450815,-45.081500000000005,2010
2273,2014-10-31,Before I Go to Sleep,22000000,19563579,3242457,2014,-2436421,-11.07464090909091,2010
3571,2014-10-31,Nightcrawler,8500000,50334418,32381218,2014,41834418,492.16962352941175,2010
5175,2014-10-31,All You Need Is Love,300000,177507,0,2014,-122493,-40.831,2010
220,2014-11-04,Rio 2,130000000,493738435,131538435,2014,363738435,279.7987961538462,2010
2078,2014-11-04,Draft Day,25000000,29276904,28842237,2014,4276904,17.107616,2010
2632,2014-11-04,The Railway Man,18000000,23910210,4438438,2014,5910210,32.8345,2010
3974,2014-11-04,Oculus,5000000,44115496,27695246,2014,39115496,782.3099199999999,2010
4214,2014-11-04,Joe,4000000,373375,373375,2014,-3626625,-90.665625,2010
100,2014-11-07,Dawn of the Planet of the Apes,170000000,710644566,208545589,2014,540644566,318.02621529411766,2010
4170,2014-11-07,Boyhood,4000000,57273049,25379975,2014,53273049,1331.826225,2010
5117,2014-11-07,As It Is in Heaven,450000,13486,13486,2014,-436514,-97.00311111111111,2010
1302,2014-11-14,Dumb and Dumber To,40000000,156553592,86208010,2014,116553592,291.38398,2010
2766,2014-11-14,The Homesman,16000000,3442853,2429989,2014,-12557147,-78.48216875,2010
3421,2014-11-14,Rosewater,10000000,3168858,3128941,2014,-6831142,-68.31142,2010
3733,2014-11-14,Beyond the Lights,7000000,14618727,14618727,2014,7618727,108.83895714285714,2010
232,2014-11-21,The Hunger Games: Mockingjay - Part 1,125000000,766652288,337135885,2014,641652288,513.3218304,2010
4831,2014-11-21,The Sleepwalker,1100000,2636,2636,2014,-1097364,-99.76036363636364,2010
210,2014-11-26,Penguins of Madagascar,132000000,367650911,83350911,2014,235650911,178.52341742424244,2010
1331,2014-11-26,Horrible Bosses 2,40000000,105945357,54445357,2014,65945357,164.8633925,2010
2800,2014-11-28,The Imitation Game,15000000,227773686,91125143,2014,212773686,1418.49124,2010
4894,2014-11-28,Antarctica: A Year on Ice,1000000,288757,288757,2014,-711243,-71.12429999999999,2010
265,2014-12-02,RoboCop,120000000,242981799,58607007,2014,122981799,102.4848325,2010
1496,2014-12-09,Dolphin Tale 2,36000000,57824533,42024533,2014,21824533,60.62370277777778,2010
3030,2014-12-09,No Good Deed,13200000,54323210,52543632,2014,41123210,311.53946969696966,2010
3095,2014-12-09,The Drop,12600000,19054534,10724389,2014,6454534,51.22646031746032,2010
4052,2014-12-09,Atlas Shrugged: Who Is John Galt?,5000000,851690,851690,2014,-4148310,-82.9662,2010
4862,2014-12-09,The Skeleton Twins,1000000,5797192,5284309,2014,4797192,479.7192,2010
5046,2014-12-09,Faith Connections,550000,9111,9111,2014,-540889,-98.34345454545455,2010
190,2014-12-12,Exodus: Gods and Kings,140000000,268314513,65014513,2014,128314513,91.65322357142857,2010
2462,2014-12-12,Inherent Vice,20000000,8692898,8110975,2014,-11307102,-56.53551,2010
3157,2014-12-12,Top Five,12000000,25514848,25317379,2014,13514848,112.62373333333333,2010
16,2014-12-17,The Hobbit: The Battle of the Five Armies,250000000,955119788,255119788,2014,705119788,282.0479152,2010
230,2014-12-19,Night at the Museum: Secret of the Tomb,127000000,356546621,113746621,2014,229546621,180.74537086614174,2010
723,2014-12-19,Annie,65000000,139840525,85911262,2014,74840525,115.13926923076923,2010
3004,2014-12-19,Mr. Turner,14000000,25187026,3958546,2014,11187026,79.90732857142856,2010
716,2014-12-25,Unbroken,65000000,163527824,115637895,2014,98527824,151.58126769230768,2010
882,2014-12-25,American Sniper,58000000,547326372,350126372,2014,489326372,843.6661586206898,2010
1010,2014-12-25,Into the Woods,50000000,203502372,128002372,2014,153502372,307.004744,2010
3378,2014-12-25,Big Eyes,10000000,27317872,14482031,2014,17317872,173.17872,2010
3475,2014-12-26,Barbecue,10000000,173613,388,2014,-9826387,-98.26387,2010
1434,2014-12-31,Dragon Nest Warriors' Dawn,40000000,196090,0,2014,-39803910,-99.509775,2010
2474,2014-12-31,A Most Violent Year,20000000,6071433,5749134,2014,-13928567,-69.642835,2010
4415,2014-12-31,Demonic,3000000,4668109,0,2014,1668109,55.603633333333335,2010
5005,2014-12-31,Destiny,750000,450,0,2014,-749550,-99.94,2010
3255,2015-01-04,Woman in Gold,11000000,56758138,33307793,2015,45758138,415.98307272727266,2010
10,2015-01-05,Avengers: Age of Ultron,250000000,1404705868,459005868,2015,1154705868,461.88234719999997,2010
129,2015-01-07,Terminator: Genisys,155000000,440160956,89760956,2015,285160956,183.97481032258065,2010
2952,2015-01-07,Magic Mike XXL,14500000,123709460,66013057,2015,109209460,753.1686896551724,2010
2947,2015-01-09,Broken Horses,15000000,3471,0,2015,-14996529,-99.97686,2010
5359,2015-01-09,Backmask,25000,428923,0,2015,403923,1615.692,2010
1857,2015-01-12,Grace of Monaco,30000000,25199891,0,2015,-4800109,-16.000363333333333,2010
684,2015-01-16,Blackhat,70000000,19548419,7889395,2015,-50451581,-72.07368714285714,2010
926,2015-01-16,Paddington,55000000,259541430,76223578,2015,204541430,371.8935090909091,2010
2200,2015-01-16,The Wedding Ringer,23000000,80171596,64460211,2015,57171596,248.57215652173915,2010
3993,2015-01-16,Still Alice,5000000,41699612,18656400,2015,36699612,733.99224,2010
3558,2015-01-20,Veronika Decides to Die,9000000,2243,0,2015,-8997757,-99.97507777777777,2010
4316,2015-01-20,The Opposite Sex,3300000,40262,0,2015,-3259738,-98.7799393939394,2010
875,2015-01-23,Mortdecai,60000000,30396134,7696134,2015,-29603866,-49.339776666666666,2010
3895,2015-01-23,Song One,6000000,32544,32251,2015,-5967456,-99.4576,2010
3938,2015-01-23,R100,5500000,24956,24956,2015,-5475044,-99.54625454545454,2010
4091,2015-01-23,Mommy,4900000,17561100,3498695,2015,12661100,258.3897959183673,2010
4167,2015-01-23,The Boy Next Door,4000000,52819253,35423380,2015,48819253,1220.4813250000002,2010
1853,2015-01-30,Wild Card,30000000,929157,3200,2015,-29070843,-96.90280999999999,2010
3161,2015-01-30,Project Almanac,12000000,32248241,22348241,2015,20248241,168.73534166666667,2010
3521,2015-01-30,Black or White,9000000,21571189,21571189,2015,12571189,139.67987777777776,2010
3776,2015-01-30,Trudno byt bogom,7000000,35919,31443,2015,-6964081,-99.48687142857143,2010
4221,2015-01-30,"Guten Tag, Ramon",4000000,4854356,154356,2015,854356,21.3589,2010
4774,2015-01-30,Above and Beyond,1300000,288751,288751,2015,-1011249,-77.78838461538462,2010
311,2015-02-10,The Martian,108000000,663851905,228433663,2015,555851905,514.6776898148148,2010
1118,2015-02-10,Shanghai,50000000,15505922,46425,2015,-34494078,-68.988156,2010
3767,2015-02-10,Freeheld,7000000,1732228,546201,2015,-5267772,-75.25388571428572,2010
386,2015-02-13,Kingsman: The Secret Service,94000000,404561724,128261724,2015,310561724,330.38481276595746,2010
1279,2015-02-13,Fifty Shades of Grey,40000000,570998101,166167230,2015,530998101,1327.4952524999999,2010
4597,2015-02-13,The Last Five Years,2000000,147299,147299,2015,-1852701,-92.63504999999999,2010
4912,2015-02-13,Hits,1000000,15156,15156,2015,-984844,-98.48440000000001,2010
2679,2015-02-20,"McFarland, USA",17000000,45707924,44480275,2015,28707924,168.87014117647058,2010
2993,2015-02-20,Hot Tub Time Machine 2,14000000,12452601,12314651,2015,-1547399,-11.05285,2010
3570,2015-02-20,The DUFF,8500000,43528634,34030343,2015,35028634,412.10157647058827,2010
3697,2015-02-24,Outside Bet,7500000,13524,0,2015,-7486476,-99.81968,2010
733,2015-02-27,Focus,65000000,154362963,53862963,2015,89362963,137.48148153846154,2010
3978,2015-02-27,The Lazarus Effect,5000000,35341814,25801570,2015,30341814,606.83628,2010
4229,2015-02-27,Praia do Futuro,4000000,760678,20620,2015,-3239322,-80.98305,2010
5260,2015-02-27,Butterfly Girl,180000,17503,17503,2015,-162497,-90.2761111111111,2010
59,2015-03-04,Furious 7,190000000,1516748684,351032910,2015,1326748684,698.2887810526316,2010
1790,2015-03-06,Entourage,30000000,46225326,32363404,2015,16225326,54.08442,2010
370,2015-03-13,Cinderella,95000000,534551353,201151353,2015,439551353,462.68563473684213,2010
1085,2015-03-13,Run All Night,50000000,66961644,26461644,2015,16961644,33.923288,2010
1630,2015-03-13,The Lovers,35000000,11106,0,2015,-34988894,-99.96826857142858,2010
3471,2015-03-13,Hross i oss,10000000,11894,11894,2015,-9988106,-99.88106,2010
4549,2015-03-13,It Follows,2000000,20649774,14674077,2015,18649774,932.4887,2010
2001,2015-03-17,Accidental Love,26000000,135436,0,2015,-25864564,-99.47909230769231,2010
288,2015-03-20,The Divergent Series: Insurgent,110000000,295279072,130179072,2015,185279072,168.43552,2010
1409,2015-03-20,The Gunman,40000000,13644292,10664749,2015,-26355708,-65.88927,2010
3410,2015-03-20,Danny Collins,10000000,7501132,5637066,2015,-2498868,-24.98868,2010
4516,2015-03-20,Do You Believe?,2300000,14305540,12985600,2015,12005540,521.98,2010
5206,2015-03-24,Along the Roadside,250000,3234,0,2015,-246766,-98.7064,2010
216,2015-03-27,Home,130000000,386069390,177397510,2015,256069390,196.97645384615385,2010
1298,2015-03-27,Get Hard,40000000,106511453,90411453,2015,66511453,166.2786325,2010
3396,2015-03-27,While We're Young,10000000,13423176,7582065,2015,3423176,34.23176,2010
754,2015-04-09,Tian jiang xiong shi,65000000,122519874,74070,2015,57519874,88.49211384615384,2010
2260,2015-04-09,The Transporter Refueled,22000000,69698495,16029670,2015,47698495,216.81134090909092,2010
4411,2015-04-09,Before We Go,3000000,379161,37151,2015,-2620839,-87.3613,2010
3252,2015-04-11,Brooklyn,11000000,62076141,38322743,2015,51076141,464.3285545454545,2010
2821,2015-04-12,Krampus,15000000,61788393,42725475,2015,46788393,311.92262,2010
3676,2015-04-14,Loin des hommes,7700000,1080428,5336,2015,-6619572,-85.96846753246753,2010
1115,2015-04-17,Child 44,50000000,3434330,1224330,2015,-46565670,-93.13134,2010
1450,2015-04-17,Paul Blart: Mall Cop 2,38000000,107597242,71038190,2015,69597242,183.15063684210526,2010
4843,2015-04-17,Unfriended,1000000,62561449,32482090,2015,61561449,6156.1449,2010
5274,2015-04-17,Antarctic Edge: 70º South,150000,7193,7193,2015,-142807,-95.20466666666667,2010
1770,2015-04-24,The Age of Adaline,30000000,69057415,42629776,2015,39057415,130.19138333333333,2010
2153,2015-04-24,Yi ge ren de wu lin,25000000,129115,129115,2015,-24870885,-99.48354,2010
2230,2015-04-24,The Water Diviner,22500000,30864649,4200117,2015,8364649,37.17621777777778,2010
2471,2015-04-24,Little Boy,20000000,17684355,6485961,2015,-2315645,-11.578225,2010
4653,2015-04-24,Brotherly Love,1900000,478595,478595,2015,-1421405,-74.81078947368421,2010
2941,2015-05-05,A Few Best Men,15000000,17224539,0,2015,2224539,14.83026,2010
3939,2015-05-05,Miss Julie,5500000,863895,0,2015,-4636105,-84.29281818181819,2010
717,2015-05-06,Spy!,65000000,233125712,110825712,2015,168125712,258.6549415384615,2010
1854,2015-05-06,United Passions,30000000,168832,918,2015,-29831168,-99.43722666666666,2010
2955,2015-05-06,Freedom,14500000,565801,0,2015,-13934199,-96.09792413793103,2010
3315,2015-05-06,Insidious Chapter 3,10000000,120678444,52218558,2015,110678444,1106.7844400000001,2010
2092,2015-05-08,Shaun the Sheep,25000000,101937062,19375982,2015,76937062,307.748248,2010
153,2015-05-15,Mad Max: Fury Road,150000000,370742166,153636354,2015,220742166,147.161444,2010
1864,2015-05-15,Pitch Perfect 2,29000000,287130801,183785415,2015,258130801,890.1062103448276,2010
4072,2015-05-15,Area 51,5000000,7556,7556,2015,-4992444,-99.84888,2010
4921,2015-05-15,Childless,1000000,1036,1036,2015,-998964,-99.8964,2010
105,2015-05-22,Tomorrowland,170000000,207283457,93436322,2015,37283457,21.931445294117648,2010
1544,2015-05-22,Poltergeist,35000000,95825125,47425125,2015,60825125,173.78607142857143,2010
3661,2015-05-22,Aloft,8000000,53086,53086,2015,-7946914,-99.33642499999999,2010
5034,2015-05-22,Drunk Wedding,600000,3301,3301,2015,-596699,-99.44983333333333,2010
285,2015-05-29,San Andreas,110000000,469590832,155190832,2015,359590832,326.90075636363633,2010
1488,2015-05-29,Aloha,37000000,24935799,21052030,2015,-12064201,-32.60594864864865,2010
2514,2015-05-29,Survivor,20000000,774905,0,2015,-19225095,-96.12547500000001,2010
80,2015-06-02,Jupiter Ascending,179000000,181982519,47482519,2015,2982519,1.6662117318435754,2010
381,2015-06-02,Seventh Son,95000000,110623265,17223265,2015,15623265,16.445542105263158,2010
616,2015-06-02,The SpongeBob Movie: Sponge Out of Water,74000000,311594032,162994032,2015,237594032,321.0730162162162,2010
1121,2015-06-03,Chappie,49000000,105002056,31569268,2015,56002056,114.28991020408164,2010
1608,2015-06-03,Unfinished Business,35000000,12819501,10219501,2015,-22180499,-63.37285428571428,2010
3332,2015-06-03,The Second Best Exotic Marigold Hotel,10000000,90384306,33078266,2015,80384306,803.84306,2010
4741,2015-06-03,Road Hard,1500000,113169,113169,2015,-1386831,-92.4554,2010
4,2015-06-11,Spectre,300000000,879620923,200074175,2015,579620923,193.20697433333333,2010
367,2015-06-11,The Peanuts Movie,99000000,250474038,130178411,2015,151474038,153.0040787878788,2010
2347,2015-06-11,Spotlight,20000000,92217729,45055776,2015,72217729,361.08864500000004,2010
84,2015-06-19,Inside Out,175000000,853707581,356461711,2015,678707581,387.8329034285714,2010
3729,2015-06-19,Dope,7000000,18190831,17506470,2015,11190831,159.8690142857143,2010
4223,2015-06-19,Manglehorn,4000000,797439,132270,2015,-3202561,-80.064025,2010
5236,2015-06-19,The Overnight,200000,1165996,1109808,2015,965996,482.998,2010
691,2015-06-26,Ted 2,68000000,217022588,81284830,2015,149022588,219.15086470588236,2010
2348,2015-06-26,Max,20000000,43658157,42656255,2015,23658157,118.29078500000001,2010
2711,2015-06-26,Escobar: Paradise Lost,17000000,1973945,195792,2015,-15026055,-88.38855882352942,2010
2000,2015-06-30,Viy,26000000,34246770,0,2015,8246770,31.718346153846156,2010
4606,2015-07-04,Lost River,2000000,45431,45431,2015,-1954569,-97.72845,2010
267,2015-07-08,Fantastic Four,120000000,167117548,56117548,2015,47117548,39.26462333333333,2010
2594,2015-07-08,Ricki and the Flash,18000000,41148679,26822144,2015,23148679,128.6037722222222,2010
3967,2015-07-08,The Gift,5000000,58978653,43787265,2015,53978653,1079.5730600000002,2010
4583,2015-07-08,The Diary of a Teenage Girl,2000000,2279959,1477002,2015,279959,13.997950000000001,2010
215,2015-07-17,Ant-Man,130000000,518602163,180202163,2015,388602163,298.92474076923077,2010
1519,2015-07-17,Trainwreck,35000000,140949327,110038130,2015,105949327,302.71236285714286,2010
5315,2015-07-17,Dawn of the Crescent Moon,75000,8799,8799,2015,-66201,-88.268,2010
414,2015-07-24,Pixels,90000000,244126300,78747585,2015,154126300,171.25144444444445,2010
1757,2015-07-24,Southpaw,30000000,94207861,52421953,2015,64207861,214.02620333333334,2010
3083,2015-07-24,The Vatican Tapes,13000000,14999638,1784763,2015,1999638,15.38183076923077,2010
3145,2015-07-24,Paper Towns,12000000,85512300,32000304,2015,73512300,612.6025000000001,2010
1698,2015-07-29,Vacation,31000000,100655892,58884188,2015,69655892,224.69642580645163,2010
147,2015-07-31,Mission: Impossible—Rogue Nation,150000000,700868363,195042377,2015,550868363,367.2455753333333,2010
1655,2015-07-31,The Young and Prodigious T.S. Spivet,33000000,357687,176847,2015,-32642313,-98.9161,2010
4903,2015-07-31,Beyond the Brick: A LEGO Brickumentary,1000000,101531,101531,2015,-898469,-89.84689999999999,2010
5333,2015-07-31,Counting,50000,8374,8374,2015,-41626,-83.25200000000001,2010
1558,2015-08-05,Hot Pursuit,35000000,45680201,34580201,2015,10680201,30.51486,2010
3283,2015-08-05,La famille Bélier,11000000,74056184,0,2015,63056184,573.2380363636364,2010
3556,2015-08-05,Skin Trade,9000000,1242,1242,2015,-8998758,-99.9862,2010
4134,2015-08-05,Maggie,4500000,597989,187112,2015,-3902011,-86.71135555555556,2010
599,2015-08-14,The Man From U.N.C.L.E.,75000000,105445109,45445109,2015,30445109,40.59347866666666,2010
1883,2015-08-14,Straight Outta Compton,28000000,202043881,161058685,2015,174043881,621.5852892857142,2010
3088,2015-08-14,Brothers,13000000,17856688,656688,2015,4856688,37.35913846153846,2010
3780,2015-08-18,Z Storm,7000000,2053330,0,2015,-4946670,-70.66671428571428,2010
1584,2015-08-21,Hitman: Agent 47,35000000,81967450,22467450,2015,46967450,134.1927142857143,2010
1918,2015-08-21,American Ultra,28000000,28208085,14439985,2015,208085,0.7431607142857143,2010
3347,2015-08-21,Sinister 2,10000000,54104225,27740955,2015,44104225,441.04225,2010
5275,2015-08-21,Top Spin,150000,5858,5858,2015,-144142,-96.09466666666665,2010
3976,2015-08-26,No Escape,5000000,42844516,27288872,2015,37844516,756.89032,2010
4332,2015-08-28,War Room,3000000,73975239,67790117,2015,70975239,2365.8413,2010
4572,2015-08-28,We Are Your Friends,2000000,10166209,3591417,2015,8166209,408.31045,2010
4807,2015-08-28,Que Horas Ela Volta?,1200000,3048209,376976,2015,1848209,154.01741666666666,2010
4973,2015-08-28,Windsor Drive,850000,3256,3256,2015,-846744,-99.61694117647059,2010
1128,2015-09-01,Taken 3,48000000,327656424,89256424,2015,279656424,582.6175499999999,2010
2339,2015-09-01,Selma,20000000,66776908,52076908,2015,46776908,233.88454,2010
3696,2015-09-01,Black November,7500000,32572,0,2015,-7467428,-99.56570666666667,2010
169,2015-09-10,Pan,150000000,123888320,35088320,2015,-26111680,-17.407786666666667,2010
1816,2015-09-10,Steve Jobs,30000000,35579007,17766658,2015,5579007,18.59669,2010
3221,2015-09-10,Trash,12000000,6553186,17484,2015,-5446814,-45.39011666666667,2010
737,2015-09-18,Everest,65000000,221662676,43309450,2015,156662676,241.01950153846153,2010
770,2015-09-18,Maze Runner: The Scorch Trials,61000000,310697192,81697192,2015,249697192,409.3396590163935,2010
979,2015-09-18,Black Mass,53000000,98837872,62575678,2015,45837872,86.48655094339622,2010
1764,2015-09-18,Sicario,30000000,78571737,46889293,2015,48571737,161.90579,2010
4575,2015-09-18,Captive,2000000,2791973,2583301,2015,791973,39.59865,2010
4812,2015-09-18,La navaja de Don Juan,1200000,4254,4254,2015,-1195746,-99.6455,2010
490,2015-09-25,Hotel Transylvania 2,80000000,470751398,169700110,2015,390751398,488.4392475,2010
1307,2015-09-25,The Intern,40000000,197232734,75764672,2015,157232734,393.081835,2010
4858,2015-09-25,The Green Inferno,1000000,12931569,7192291,2015,11931569,1193.1569,2010
4745,2015-09-28,"Me, You and Five Bucks",1500000,2105,2105,2015,-1497895,-99.85966666666667,2010
1610,2015-09-30,The Walk,35000000,61173364,10137502,2015,26173364,74.78104,2010
2158,2015-10-03,Red Sky,25000000,91116,0,2015,-24908884,-99.635536,2010
3482,2015-10-03,Jungle Shuffle,10000000,314073,0,2015,-9685927,-96.85927,2010
1635,2015-10-04,The Longest Ride,34000000,63802928,37446117,2015,29802928,87.6556705882353,2010
3057,2015-10-04,Ex Machina,13000000,38976797,25440971,2015,25976797,199.8215153846154,2010
4220,2015-10-04,Desert Dancer,4000000,324218,155271,2015,-3675782,-91.89455,2010
4918,2015-10-04,The Sisterhood of Night,1000000,6870,6870,2015,-993130,-99.313,2010
615,2015-10-07,Minions,74000000,1167245366,336045770,2015,1093245366,1477.3586027027027,2010
1415,2015-10-07,Baahubali: The Beginning,40000000,26736665,6738000,2015,-13263335,-33.1583375,2010
1994,2015-10-07,Self/Less,26000000,33713827,12279691,2015,7713827,29.668565384615388,2010
3470,2015-10-07,Strangerland,10000000,161097,17472,2015,-9838903,-98.38903,2010
883,2015-10-16,Goosebumps,58000000,158905324,80069458,2015,100905324,173.97469655172412,2010
953,2015-10-16,Crimson Peak,55000000,75466595,31090320,2015,20466595,37.21199090909091,2010
1311,2015-10-16,Bridge of Spies,40000000,162610473,72313754,2015,122610473,306.5261825,2010
2926,2015-10-16,Nie yin niang,15000000,6832542,632542,2015,-8167458,-54.44972,2010
3065,2015-10-16,Room,13000000,36262783,14677674,2015,23262783,178.94448461538462,2010
542,2015-10-23,The Last Witch Hunter,80000000,131234406,27367660,2015,51234406,64.0430075,2010
3002,2015-10-23,Suffragette,14000000,34044909,4702420,2015,20044909,143.1779214285714,2010
3362,2015-10-23,Paranormal Activity: The Ghost Dimension,10000000,78096553,18297124,2015,68096553,680.9655300000001,2010
4047,2015-10-23,Jem and the Holograms,5000000,2368937,2184640,2015,-2631063,-52.62126000000001,2010
4622,2015-10-23,Bone Tomahawk,2000000,481525,0,2015,-1518475,-75.92375,2010
5174,2015-10-23,The Looking Glass,300000,1711,1711,2015,-298289,-99.42966666666668,2010
1924,2015-10-30,Our Brand is Crisis,28000000,8592432,7002261,2015,-19407568,-69.31274285714287,2010
2434,2015-10-30,Burnt,20000000,32632668,13651946,2015,12632668,63.16334,2010
2509,2015-10-30,Regression,20000000,14883495,55039,2015,-5116505,-25.582525,2010
2914,2015-10-30,Scout's Guide to the Zombie Apocalypse,15000000,14947243,3703046,2015,-52757,-0.3517133333333333,2010
2578,2015-11-09,The Perfect Guy,18000000,60264805,57017904,2015,42264805,234.80447222222222,2010
3961,2015-11-09,The Visit,5000000,98595211,65112020,2015,93595211,1871.9042200000001,2010
4036,2015-11-09,90 Minutes in Heaven,5000000,4816142,4816142,2015,-183858,-3.67716,2010
3223,2015-11-11,10 Days in a Madhouse,12000000,14616,14616,2015,-11985384,-99.87819999999999,2010
361,2015-11-12,In the Heart of the Sea,100000000,90420758,25020758,2015,-9579242,-9.579242,2010
1888,2015-11-12,The Big Short,28000000,133162752,70259870,2015,105162752,375.5812571428571,2010
4927,2015-11-12,American Hero,1000000,26,0,2015,-999974,-99.9974,2010
2116,2015-11-13,The 33,25000000,28400715,12227722,2015,3400715,13.60286,2010
2489,2015-11-13,My All-American,20000000,2246000,2246000,2015,-17754000,-88.77000000000001,2010
2500,2015-11-13,By the Sea,20000000,3727746,538460,2015,-16272254,-81.36126999999999,2010
2597,2015-11-13,Love the Coopers,18000000,42167286,26302731,2015,24167286,134.2627,2010
3562,2015-11-13,Heist,8900000,3324184,50136,2015,-5575816,-62.649617977528095,2010
118,2015-11-20,The Hunger Games: Mockingjay - Part 2,160000000,650523427,281723902,2015,490523427,306.577141875,2010
2051,2015-11-20,The Night Before,25000000,52427346,43035725,2015,27427346,109.70938400000001,2010
2143,2015-11-20,Legend,25000000,42642077,1872994,2015,17642077,70.568308,2010
2404,2015-11-20,Secret in Their Eyes,20000000,30808558,20180155,2015,10808558,54.04279,2010
3783,2015-11-20,Criminal Activities,7000000,103962,0,2015,-6896038,-98.51482857142857,2010
5115,2015-11-20,Siakh lokhamim: ha'slilim ha'gnouzim,450000,42503,41260,2015,-407497,-90.55488888888888,2010
65,2015-11-25,The Good Dinosaur,187500000,334342692,123087120,2015,146842692,78.3161024,2010
1417,2015-11-25,Victor Frankenstein,40000000,33175076,5775076,2015,-6824924,-17.06231,2010
1478,2015-11-25,Creed,37000000,173567581,109767581,2015,136567581,369.10157027027026,2010
28,2015-12-06,Jurassic World,215000000,1671640593,652198010,2015,1456640593,677.5072525581395,2010
3632,2015-12-06,Me and Earl and the Dying Girl,8000000,9266180,6758416,2015,1266180,15.827250000000001,2010
2,2015-12-18,Star Wars Ep. VII: The Force Awakens,306000000,2058662225,936662225,2015,1752662225,572.7654330065359,2010
411,2015-12-18,Alvin and the Chipmunks: The Road Chip,90000000,249520430,85886987,2015,159520430,177.24492222222221,2010
1724,2015-12-18,Sisters,30000000,106030660,87044645,2015,76030660,253.43553333333335,2010
360,2015-12-25,Point Break,100000000,128131571,28782481,2015,28131571,28.131571,2010
765,2015-12-25,The Hateful Eight,62000000,145443360,54117416,2015,83443360,134.58606451612903,2010
819,2015-12-25,Joy,60000000,101134059,56451232,2015,41134059,68.556765,2010
1007,2015-12-25,Daddy’s Home,50000000,238757137,150357137,2015,188757137,377.514274,2010
1559,2015-12-25,Concussion,35000000,50363790,34531832,2015,15363790,43.896542857142855,2010
3638,2015-12-30,Anomalisa,8000000,5531455,3759286,2015,-2468545,-30.856812500000004,2010
556,2015-12-31,"Don Gato, el inicio de la pandilla",80000000,4547660,0,2015,-75452340,-94.31542499999999,2010
1271,2015-12-31,Pourquoi j'ai pas mangé mon père,42000000,182156,0,2015,-41817844,-99.56629523809524,2010
1861,2015-12-31,Bilal,30000000,141661,0,2015,-29858339,-99.52779666666667,2010
2942,2015-12-31,Chiamatemi Francesco - Il papa della gente,15000000,3454036,0,2015,-11545964,-76.97309333333334,2010
3781,2015-12-31,ГЕРОЙ,7000000,1391410,0,2015,-5608590,-80.12271428571428,2010
4452,2015-12-31,Sardaar Ji,2700000,8200000,0,2015,5500000,203.70370370370372,2010
4625,2015-12-31,"To Be Frank, Sinatra at 100",2000000,926,0,2015,-1999074,-99.9537,2010
4659,2015-12-31,Vaalu,1900000,12444,0,2015,-1887556,-99.34505263157895,2010
4925,2015-12-31,Karachi se Lahore,1000000,17721,0,2015,-982279,-98.2279,2010
5042,2015-12-31,Julija in alfa Romeo,560000,8462,0,2015,-551538,-98.48892857142857,2010
5267,2015-12-31,Lumea e a mea,168000,29827,0,2015,-138173,-82.24583333333332,2010
3986,2016-01-04,God’s Not Dead 2,5000000,23565072,20773069,2016,18565072,371.30144,2010
4961,2016-01-04,Meet the Blacks,900000,9097072,9097072,2016,8197072,910.7857777777778,2010
77,2016-01-07,The Legend of Tarzan,180000000,349143061,126643061,2016,169143061,93.96836722222223,2010
191,2016-01-07,The BFG,140000000,154110769,55483770,2016,14110769,10.079120714285713,2010
3308,2016-01-07,The Purge: Election Year,10000000,118557124,79042440,2016,108557124,1085.57124,2010
3014,2016-01-11,Reign of Assassins,14000000,11354230,0,2016,-2645770,-18.89835714285714,2010
1045,2016-01-15,13 Hours: The Secret Soldiers of Benghazi,50000000,69411370,52853219,2016,19411370,38.82274,2010
1296,2016-01-15,Ride Along 2,40000000,124827316,90862685,2016,84827316,212.06829,2010
2608,2016-01-15,Norm of the North,18000000,27392196,17062499,2016,9392196,52.178866666666664,2010
905,2016-01-22,Zhuo yao ji,56000000,386096060,32766,2016,330096060,589.4572499999999,2010
1459,2016-01-22,The 5th Wave,38000000,110678636,34912982,2016,72678636,191.25956842105262,2010
1504,2016-01-22,Yip Man 3,36000000,156835197,2679437,2016,120835197,335.653325,2010
3236,2016-01-22,Dirty Grandpa,11500000,99930262,35593113,2016,88430262,768.9588,2010
3327,2016-01-22,The Boy,10000000,68220952,35819556,2016,58220952,582.20952,2010
185,2016-01-29,Kung Fu Panda 3,140000000,518614384,143528619,2016,378614384,270.4388457142857,2010
674,2016-01-29,The Finest Hours,70000000,48197252,27569558,2016,-21802748,-31.146782857142856,2010
2145,2016-01-29,Jane Got a Gun,25000000,2976636,1513793,2016,-22023364,-88.093456,2010
4014,2016-01-29,Fifty Shades of Black,5000000,20765353,11686940,2016,15765353,315.30706,2010
2441,2016-02-09,The Light Between Oceans,20000000,19450780,12545979,2016,-549220,-2.7460999999999998,2010
3637,2016-02-09,Morgan,8000000,7315248,3915251,2016,-684752,-8.5594,2010
4076,2016-02-09,Yoga Hosers,5000000,2199,0,2016,-4997801,-99.95602,2010
3528,2016-02-12,Jackie,9000000,25077411,13960394,2016,16077411,178.6379,2010
772,2016-02-19,Mei Ren Yu,60720000,552198479,3229457,2016,491478479,809.417784914361,2010
2359,2016-02-19,Risen,20000000,46164361,36880033,2016,26164361,130.821805,2010
3991,2016-02-19,Race,5000000,22178125,19115191,2016,17178125,343.5625,2010
4269,2016-02-19,The Witch,3500000,40454520,25138705,2016,36954520,1055.8434285714286,2010
192,2016-02-26,Gods of Egypt,140000000,133553464,31153464,2016,-6446536,-4.604668571428571,2010
2212,2016-02-26,Eddie the Eagle,23000000,45121177,15789389,2016,22121177,96.1790304347826,2010
2440,2016-02-26,Triple 9,20000000,25943792,12639297,2016,5943792,29.71896,2010
206,2016-03-06,Teenage Mutant Ninja Turtles: Out of the Shadows,135000000,245623848,82051601,2016,110623848,81.94359111111112,2010
2336,2016-03-06,Me Before You,20000000,205445075,56245075,2016,185445075,927.2253750000001,2010
2454,2016-03-06,Popstar: Never Stop Never Stopping,20000000,9537120,9496130,2016,-10462880,-52.314400000000006,2010
4291,2016-03-06,Time to Choose,3500000,29233,29233,2016,-3470767,-99.16477142857143,2010
5265,2016-03-06,The Fits,170000,169242,166425,2016,-758,-0.4458823529411765,2010
3035,2016-03-16,Miracles from Heaven,13000000,73798720,61705123,2016,60798720,467.6824615384615,2010
300,2016-03-18,The Divergent Series: Allegiant,110000000,171484051,66184051,2016,61484051,55.894591818181816,2010
2634,2016-03-18,Midnight Special,18000000,6841142,3712282,2016,-11158858,-61.99365555555556,2010
12,2016-03-25,Batman v Superman: Dawn of Justice,250000000,868160194,330360194,2016,618160194,247.2640776,2010
2577,2016-03-25,My Big Fat Greek Wedding 2,18000000,91651878,59689605,2016,73651878,409.17709999999994,2010
3416,2016-03-30,Everybody Wants Some,10000000,5437126,3400278,2016,-4562874,-45.62874,2010
136,2016-04-03,Zootopia,150000000,1019922983,341268248,2016,869922983,579.9486553333334,2010
811,2016-04-03,London Has Fallen,60000000,193857962,62524260,2016,133857962,223.09660333333335,2010
1582,2016-04-03,Whiskey Tango Foxtrot,35000000,24915969,23083334,2016,-10084031,-28.81151714285714,2010
5035,2016-04-03,They Will Have to Kill Us First,600000,7943,0,2016,-592057,-98.67616666666666,2010
108,2016-04-11,Doctor Strange,165000000,677541920,232641920,2016,512541920,310.63146666666665,2010
244,2016-04-11,Trolls,125000000,344780046,153707064,2016,219780046,175.82403680000002,2010
1317,2016-04-11,Hacksaw Ridge,40000000,158701644,67209615,2016,118701644,296.75411,2010
83,2016-04-15,The Jungle Book,175000000,963901123,364001123,2016,788901123,450.8006417142857,2010
1692,2016-04-15,Criminal,31500000,38771262,14708696,2016,7271262,23.08337142857143,2010
2337,2016-04-15,Barbershop: The Next Cut,20000000,54404202,54030051,2016,34404202,172.02101000000002,2010
2649,2016-04-15,I Am Wrath,18000000,6784,0,2016,-17993216,-99.96231111111112,2010
4042,2016-04-15,Green Room,5000000,3807503,3220371,2016,-1192497,-23.84994,2010
278,2016-04-22,The Huntsman: Winter’s War,115000000,165149302,48003015,2016,50149302,43.60808869565218,2010
4384,2016-04-22,Compadres,3000000,7445044,3127773,2016,4445044,148.16813333333334,2010
4728,2016-04-22,Unsullied,1500000,510957,510957,2016,-989043,-65.9362,2010
2458,2016-04-29,Ratchet and Clank,20000000,11813410,8813410,2016,-8186590,-40.93295,2010
2861,2016-04-29,Keanu,15000000,20609977,20591853,2016,5609977,37.39984666666666,2010
878,2016-05-02,Xi You Ji zhi Sun Wu Kong San Da Bai Gu Jing,60000000,194058503,709982,2016,134058503,223.43083833333336,2010
1920,2016-05-02,Pride and Prejudice and Zombies,28000000,16311335,10907291,2016,-11688665,-41.74523214285714,2010
2248,2016-05-02,"Hail, Caesar!",22000000,64171419,30080225,2016,42171419,191.6882681818182,2010
3285,2016-05-02,Misconduct,11000000,2124005,0,2016,-8875995,-80.69086363636364,2010
85,2016-05-08,Suicide Squad,175000000,746100054,325100054,2016,571100054,326.342888,2010
3094,2016-05-08,Operation Chromite,12700000,49196532,1022720,2016,36496532,287.3742677165354,2010
1944,2016-05-13,Money Monster,27000000,93469699,41012075,2016,66469699,246.18407037037036,2010
4183,2016-05-13,The Darkness,4000000,10898293,10753574,2016,6898293,172.457325,2010
619,2016-05-20,The Angry Birds Movie,73000000,352829528,107509366,2016,279829528,383.3281205479452,2010
1070,2016-05-20,The Nice Guys,50000000,57261763,36261763,2016,7261763,14.523526,2010
1539,2016-05-20,Neighbors 2: Sorority Rising,35000000,108758521,55340730,2016,73758521,210.73863142857144,2010
81,2016-05-27,X-Men: Apocalypse,178000000,542742489,155442489,2016,364742489,204.91151067415728,2010
106,2016-05-27,Alice Through the Looking Glass,170000000,277442381,77042381,2016,107442381,63.20140058823529,2010
11,2016-06-05,Captain America: Civil War,250000000,1151684349,408084349,2016,901684349,360.67373960000003,2010
3549,2016-06-05,Dheepan,9000000,7714549,248795,2016,-1285451,-14.28278888888889,2010
3779,2016-06-12,Oddball,7000000,10237239,0,2016,3237239,46.246271428571426,2010
39,2016-06-17,Finding Dory,200000000,1022617376,486295561,2016,822617376,411.308688,2010
1011,2016-06-17,Central Intelligence,50000000,217196811,127440871,2016,167196811,334.393622,2010
113,2016-06-24,Independence Day: Resurgence,165000000,387644286,103144286,2016,222644286,134.9359309090909,2010
1095,2016-06-24,Free State of Jones,50000000,23152062,20810036,2016,-26847938,-53.695876,2010
3039,2016-06-24,The Shallows,13000000,118888025,55121623,2016,105888025,814.5232692307692,2010
3691,2016-06-24,The Neon Demon,7500000,3559803,1333124,2016,-3940197,-52.53596,2010
4373,2016-06-24,Swiss Army Man,3000000,5100863,4210454,2016,2100863,70.02876666666667,2010
4482,2016-06-24,Hunt for the Wilderpeople,2500000,23014021,5205471,2016,20514021,820.5608399999999,2010
1174,2016-07-10,The Girl on the Train,45000000,170327930,75395035,2016,125327930,278.50651111111114,2010
3372,2016-07-10,The Birth of a Nation,10000000,16084310,15861566,2016,6084310,60.84310000000001,2010
3575,2016-07-10,Middle School: The Worst Years of My Life,8500000,23311425,20007149,2016,14811425,174.2520588235294,2010
1141,2016-07-13,The Infiltrator,47500000,18329653,15436808,2016,-29170347,-61.41125684210527,2010
179,2016-07-15,Ghostbusters,144000000,229034050,128350574,2016,85034050,59.05142361111111,2010
4008,2016-07-15,Hillary’s America: The Secret History of the Democratic Party,5000000,13099931,13099931,2016,8099931,161.99862000000002,2010
71,2016-07-22,Star Trek Beyond,185000000,336398312,158848340,2016,151398312,81.83692540540541,2010
316,2016-07-22,Ice Age: Collision Course,105000000,403841637,64063008,2016,298841637,284.6110828571429,2010
3960,2016-07-22,Lights Out,5000000,148868835,67268835,2016,143868835,2877.3767,2010
4372,2016-07-22,Don’t Think Twice,3000000,4417983,4417983,2016,1417983,47.2661,2010
2354,2016-07-27,Nerve,20000000,61680792,38583626,2016,41680792,208.40396,2010
256,2016-07-29,Jason Bourne,120000000,416197059,162192920,2016,296197059,246.83088249999997,2010
2317,2016-07-29,Bad Moms,20000000,181457297,113257297,2016,161457297,807.286485,2010
201,2016-08-01,The Revenant,135000000,532950503,183637894,2016,397950503,294.7781503703704,2010
3348,2016-08-01,The Forest,10000000,40055439,26594261,2016,30055439,300.55439,2010
4288,2016-08-01,The Masked Saint,3500000,182695,182695,2016,-3317305,-94.78014285714286,2010
1859,2016-08-03,Savva. Serdtse voyna,30000000,1769316,0,2016,-28230684,-94.10228000000001,2010
1866,2016-08-04,The Boss,29000000,78652395,63077560,2016,49652395,171.2151551724138,2010
4897,2016-08-04,The Invitation,1000000,354836,231738,2016,-645164,-64.51639999999999,2010
572,2016-08-07,The Secret Life of Pets,75000000,875958307,368384330,2016,800958307,1067.9444093333334,2010
1646,2016-08-07,Mike and Dave Need Wedding Dates,33000000,75909673,46009673,2016,42909673,130.02931212121212,2010
380,2016-08-19,Ben-Hur,95000000,88725100,26410477,2016,-6274900,-6.605157894736842,2010
943,2016-08-19,Kubo and the Two Strings,55000000,74545591,48023088,2016,19545591,35.53743818181818,2010
1059,2016-08-19,War Dogs,50000000,83034523,43034523,2016,33034523,66.069046,2010
2480,2016-08-26,Hands of Stone,20000000,4754517,4712792,2016,-15245483,-76.227415,2010
3305,2016-08-26,Don’t Breathe,10000000,158185073,89217875,2016,148185073,1481.85073,2010
3542,2016-08-26,Greater,9000000,2000093,2000093,2016,-6999907,-77.77674444444445,2010
781,2016-09-09,Sully,60000000,238552082,125070033,2016,178552082,297.5868033333333,2010
3341,2016-09-09,When the Bough Breaks,10000000,30629507,29747603,2016,20629507,206.29507,2010
3457,2016-09-09,Kicks,10000000,150191,150191,2016,-9849809,-98.49809,2010
1187,2016-09-12,Office Christmas Party,45000000,91342494,54767494,2016,46342494,102.98331999999999,2010
2311,2016-09-12,La La Land,20000000,433574208,151101803,2016,413574208,2067.87104,2010
1093,2016-09-16,Snowden,50000000,34301950,21587519,2016,-15698050,-31.3961,2010
1579,2016-09-16,Bridget Jones’s Baby,35000000,203555567,24139805,2016,168555567,481.58733428571423,2010
3356,2016-09-16,Blair Witch,10000000,37493221,20777061,2016,27493221,274.93221,2010
410,2016-09-23,The Magnificent Seven,90000000,159762983,93427848,2016,69762983,77.51442555555556,2010
655,2016-09-23,Storks,70000000,174102281,72679278,2016,104102281,148.7175442857143,2010
3232,2016-09-23,The Dressmaker,11900000,24041617,2022115,2016,12141617,102.03039495798319,2010
127,2016-09-30,Deepwater Horizon,156000000,113611666,61433527,2016,-42388334,-27.172008974358974,2010
296,2016-09-30,Miss Peregrine’s Home for Peculiar Children,110000000,296642834,87242834,2016,186642834,169.67530363636362,2010
125,2016-10-06,Warcraft,160000000,433125655,47225655,2016,273125655,170.703534375,2010
421,2016-10-06,Now You See Me 2,90000000,328675540,65075540,2016,238675540,265.1950444444445,2010
1290,2016-10-06,The Conjuring 2: The Enfield Poltergeist,40000000,311270008,102470008,2016,271270008,678.17502,2010
2709,2016-10-06,Genius,17000000,5653176,1361045,2016,-11346824,-66.74602352941177,2010
1301,2016-10-14,The Accountant,40000000,153060045,86260045,2016,113060045,282.6501125,2010
3353,2016-10-14,Kevin Hart: What Now?,10000000,23591043,23591043,2016,13591043,135.91043,2010
4536,2016-10-16,Mi America,2100000,3330,3330,2016,-2096670,-99.84142857142857,2010
816,2016-10-21,Jack Reacher: Never Go Back,60000000,160038407,58697076,2016,100038407,166.73067833333332,2010
2326,2016-10-21,Tyler Perry’s Boo! A Madea Halloween,20000000,73206343,73206343,2016,53206343,266.031715,2010
3517,2016-10-21,Ouija: Origin of Evil,9000000,81831866,35144505,2016,72831866,809.2429555555557,2010
4707,2016-10-21,Moonlight,1500000,55800987,27854931,2016,54300987,3620.0658,2010
4723,2016-10-21,I’m Not Ashamed,1500000,2082980,2082980,2016,582980,38.86533333333333,2010
608,2016-10-28,Inferno,75000000,219572877,34355263,2016,144572877,192.763836,2010
1615,2016-11-03,The Brothers Grimsby,35000000,28721408,6864016,2016,-6278592,-17.938834285714286,2010
2714,2016-11-03,The Young Messiah,16800000,7313697,6469813,2016,-9486303,-56.46608928571428,2010
3060,2016-11-03,Eye in the Sky,13000000,34916128,18704596,2016,21916128,168.5856,2010
3959,2016-11-03,10 Cloverfield Lane,5000000,108286422,72082999,2016,103286422,2065.7284400000003,2010
4021,2016-11-03,The Perfect Match,5000000,9669521,9669521,2016,4669521,93.39041999999999,2010
4906,2016-11-03,Creative Control,1000000,63014,63014,2016,-936986,-93.6986,2010
1143,2016-11-11,Arrival,47000000,203178872,100546139,2016,156178872,332.29547234042553,2010
1423,2016-11-11,Billy Lynn’s Long Halftime Walk,40000000,25863458,1738477,2016,-14136542,-35.341355,2010
1433,2016-11-11,USS Indianapolis: Men of Courage,40000000,1079040,0,2016,-38920960,-97.3024,2010
2680,2016-11-11,Almost Christmas,17000000,42141196,42065185,2016,25141196,147.88938823529412,2010
3401,2016-11-11,Shut In,10000000,8457974,6900335,2016,-1542026,-15.420259999999999,2010
74,2016-11-18,Fantastic Beasts and Where to Find Them,180000000,803798342,234037575,2016,623798342,346.55463444444445,2010
2229,2016-11-18,Nocturnal Animals,22500000,30719170,10663357,2016,8219170,36.52964444444444,2010
2761,2016-11-18,Bleed for This,16000000,6248077,5083906,2016,-9751923,-60.949518749999996,2010
3527,2016-11-18,The Edge of Seventeen,9000000,18802255,14431633,2016,9802255,108.91394444444444,2010
3567,2016-11-18,Manchester by the Sea,8500000,75740479,47695371,2016,67240479,791.0644588235294,2010
3659,2016-11-18,A Street Cat Named Bob,8000000,8370555,82703,2016,370555,4.6319375,2010
141,2016-11-23,Moana,150000000,639537208,248757044,2016,489537208,326.35813866666666,2010
1965,2016-11-23,Rules Don’t Apply,26700000,3871448,3652206,2016,-22828552,-85.50019475655431,2010
2635,2016-11-25,Miss Sloane,18000000,5823540,3500605,2016,-12176460,-67.647,2010
3138,2016-11-25,Lion,12000000,145712897,51728731,2016,133712897,1114.2741416666668,2010
567,2016-12-02,The Little Prince,77500000,90905178,1311213,2016,13405178,17.297003870967743,2010
881,2016-12-02,Deadpool,58000000,801029249,363070709,2016,743029249,1281.0849120689654,2010
1078,2016-12-02,Zoolander 2,50000000,55348693,28848693,2016,5348693,10.697386,2010
1483,2016-12-02,How to be Single,37000000,99595932,46843513,2016,62595932,169.1781945945946,2010
725,2016-12-08,Pete’s Dragon,65000000,137768975,76233151,2016,72768975,111.95226923076925,2010
1870,2016-12-08,Florence Foster Jenkins,29000000,44267641,27383770,2016,15267641,52.64703793103448,2010
2531,2016-12-08,Sausage Party,19000000,140428314,97670358,2016,121428314,639.0963894736842,2010
3154,2016-12-08,Hell or High Water,12000000,37584304,27007844,2016,25584304,213.20253333333335,2010
38,2016-12-16,Rogue One: A Star Wars Story,200000000,1050988488,532177324,2016,850988488,425.494244,2010
1497,2016-12-16,Collateral Beauty,36000000,85315070,31016021,2016,49315070,136.98630555555556,2010
250,2016-12-21,Assassin’s Creed,125000000,240497948,54647948,2016,115497948,92.3983584,2010
294,2016-12-21,Passengers,110000000,302211243,100014092,2016,192211243,174.73749363636364,2010
574,2016-12-21,Sing,75000000,627886287,270329045,2016,552886287,737.181716,2010
1367,2016-12-21,Patriots Day,40000000,44383030,31886361,2016,4383030,10.957575,2010
1151,2016-12-23,Silence,46500000,16149791,7100177,2016,-30350209,-65.26926666666667,2010
1452,2016-12-23,Why Him?,38000000,117523786,60323786,2016,79523786,209.27312105263155,2010
751,2016-12-25,Live by Night,65000000,21778555,10378555,2016,-43221445,-66.49453076923076,2010
2010,2016-12-25,Hidden Figures,25000000,229518131,169374490,2016,204518131,818.0725239999999,2010
4147,2016-12-31,Airlift (2016),4400000,9969237,0,2016,5569237,126.57356818181817,2010
251,2017-01-13,Monster Trucks,125000000,61681268,33370166,2017,-63318732,-50.6549856,2010
3699,2017-01-13,The Bye Bye Man,7400000,25863405,22395806,2017,18463405,249.50547297297297,2010
466,2017-01-20,xXx: Return of Xander Cage,85000000,345114933,44898413,2017,260114933,306.0175682352941,2010
2880,2017-01-20,The Founder,15000000,18301418,12786243,2017,3301418,22.009453333333333,2010
3955,2017-01-20,Split,5000000,276841585,138141585,2017,271841585,5436.8317,2010
1379,2017-01-27,Resident Evil: The Final Chapter,40000000,307353906,26844692,2017,267353906,668.384765,2010
2032,2017-01-27,A Dog’s Purpose,25000000,189922583,64321890,2017,164922583,659.690332,2010
5355,2017-01-27,Emily,27000,3547,3547,2017,-23453,-86.86296296296297,2010
3791,2017-01-31,Two Lovers and a Bear,6840000,22273,0,2017,-6817727,-99.67437134502924,2010
135,2017-02-06,Wonder Woman,150000000,785964691,395674792,2017,635964691,423.97646066666664,2010
1449,2017-02-06,Captain Underpants: The First Epic Movie,38000000,87098466,72498466,2017,49098466,129.2064894736842,2010
168,2017-02-17,The Great Wall,150000000,331775766,45157105,2017,181775766,121.183844,2010
2071,2017-02-17,Fist Fight,25000000,40287017,32187017,2017,15287017,61.148068,2010
2946,2017-02-17,In Dubious Battle,15000000,4892,0,2017,-14995108,-99.96738666666667,2010
874,2017-02-24,Rock Dog,60000000,20830546,9420546,2017,-39169454,-65.28242333333333,2010
1863,2017-02-24,Collide,29200000,5278519,2280004,2017,-23921481,-81.9228801369863,2010
2301,2017-02-24,Bitter Harvest,21000000,606162,557241,2017,-20393838,-97.11351428571429,2010
3954,2017-02-24,Get Out,5000000,251359904,175484140,2017,246359904,4927.19808,2010
2080,2017-03-02,Rings,25000000,82991460,27793018,2017,57991460,231.96584,2010
4608,2017-03-02,Growing up Smith,2000000,35312,35312,2017,-1964688,-98.2344,2010
229,2017-03-03,Logan,127000000,615577068,226277068,2017,488577068,384.7063527559055,2010
115,2017-03-17,Beauty and the Beast,160000000,1260122363,504014165,2017,1100122363,687.576476875,2010
2639,2017-03-17,T2: Trainspotting,18000000,42067430,2395410,2017,24067430,133.70794444444445,2010
4020,2017-03-17,The Belko Experiment,5000000,10744134,10166820,2017,5744134,114.88268,2010
263,2017-03-24,Power Rangers,120000000,140845191,85364450,2017,20845191,17.3709925,2010
891,2017-03-24,Life,58000000,100993260,30223972,2017,42993260,74.12631034482759,2010
2094,2017-03-24,CHiPS,25000000,23190697,18600152,2017,-1809303,-7.2372119999999995,2010
242,2017-03-31,The Boss Baby,125000000,492557218,174678355,2017,367557218,294.0457744,2010
306,2017-03-31,Ghost in the Shell,110000000,167918847,40563557,2017,57918847,52.653497272727265,2010
18,2017-04-14,The Fate of the Furious,250000000,1237444462,225764765,2017,987444462,394.9777848,2010
1506,2017-04-14,Queen of the Desert,36000000,1480089,0,2017,-34519911,-95.88864166666666,2010
432,2017-04-21,The Promise,90000000,10020889,8224288,2017,-79979111,-88.8656788888889,2010
3180,2017-04-21,Unforgettable,12000000,15668012,11368012,2017,3668012,30.566766666666666,2010
3429,2017-04-21,Free Fire,10000000,3565109,1799322,2017,-6434891,-64.34891,2010
1812,2017-04-28,Baahubali 2: The Conclusion,30000000,184075552,18985794,2017,154075552,513.5851733333334,2010
2498,2017-04-28,Jìyì dàshī,20000000,43326383,587470,2017,23326383,116.631915,2010
2603,2017-04-28,The Circle,18000000,33907844,20497844,2017,15907844,88.37691111111111,2010
42,2017-05-05,Guardians of the Galaxy Vol 2,200000000,858470006,387805844,2017,658470006,329.235003,2010
2225,2017-05-05,Chāi dàn zhuānjiā,23000000,58807172,0,2017,35807172,155.6833565217391,2010
2253,2017-05-19,Diary of a Wimpy Kid: The Long Haul,22000000,35409686,20710572,2017,13409686,60.953118181818176,2010
3329,2017-05-19,"Everything, Everything",10000000,45921140,34121140,2017,35921140,359.2114,2010
817,2017-05-25,Baywatch,60000000,169740988,58060186,2017,109740988,182.90164666666666,2010
20,2017-05-26,Pirates of the Caribbean: Dead Men Tell No Tales,230000000,776037086,171037086,2017,546037086,237.4074286956522,2010
1244,2017-06-01,A Monster Calls,43000000,45095823,3740823,2017,2095823,4.874006976744186,2010
1197,2017-06-16,All Eyez on Me,45000000,54855235,44900235,2017,9855235,21.90052222222222,2010
2397,2017-06-16,Rough Night,20000000,41015970,21906917,2017,21015970,105.07985,2010
27,2017-06-21,Transformers: The Last Knight,217000000,568923844,128866562,2017,351923844,162.1768866359447,2010
1634,2017-06-28,Baby Driver,34000000,139359078,92558357,2017,105359078,309.8796411764706,2010
575,2017-06-30,Despicable Me 3,75000000,823755831,231351340,2017,748755831,998.341108,2010
1383,2017-06-30,The House,40000000,30576502,24938902,2017,-9423498,-23.558745000000002,2010
4832,2017-07-03,Departure,1100000,27561,0,2017,-1072439,-97.49445454545454,2010
834,2017-07-04,Smurfs: The Lost Village,60000000,197242826,45011202,2017,137242826,228.73804333333334,2010
2171,2017-07-04,Going in Style,24000000,78714211,45018541,2017,54714211,227.97587916666666,2010
87,2017-07-07,Spider-Man: Homecoming,175000000,638087983,279991585,2017,463087983,264.62170457142855,2010
131,2017-07-14,War for the Planet of the Apes,152000000,225986078,120086079,2017,73986078,48.675051315789474,2010
3174,2017-07-14,Wish Upon,12000000,19379463,12929463,2017,7379463,61.495524999999994,2010
79,2017-07-21,Valerian and the City of a Thousand Planets,180000000,52573132,31023132,2017,-127426868,-70.79270444444444,2010
162,2017-07-21,Dunkirk,150000000,235907054,104641608,2017,85907054,57.27136933333333,2010
1890,2017-07-21,Girls Trip,28000000,69290699,67206670,2017,41290699,147.46678214285714,2010
1081,2017-07-28,The Emoji Movie,50000000,27366288,27365212,2017,-22633712,-45.267424,2010
1808,2017-07-28,Atomic Blonde,30000000,23095325,20095325,2017,-6904675,-23.015583333333332,2010
4901,2017-07-28,An Inconvenient Sequel,1000000,130874,130874,2017,-869126,-86.9126,2010
1856,2017-08-25,Ballerina,30000000,48048527,0,2017,18048527,60.16175666666667,2010
4237,2017-08-25,Polina danser sa vie,4000000,36630,0,2017,-3963370,-99.08425,2010
57,2017-09-06,The Mummy,195000000,397644453,79741080,2017,202644453,103.92023230769232,2010
4004,2017-09-06,It Comes at Night,5000000,17250101,13845101,2017,12250101,245.00202,2010
489,2017-10-02,The Lego Batman Movie,80000000,310940997,175750384,2017,230940997,288.67624625,2010
914,2017-10-02,Fifty Shades Darker,55000000,376856949,114434010,2017,321856949,585.1944527272727,2010
1295,2017-10-02,John Wick: Chapter Two,40000000,166893990,92029184,2017,126893990,317.234975,2010
70,2017-10-03,Kong: Skull Island,185000000,561137727,168052812,2017,376137727,203.3176902702703,2010
94,2017-12-05,King Arthur: Legend of the Sword,175000000,140012608,39175066,2017,-34987392,-19.992795428571426,2010
1254,2017-12-05,Snatched,42000000,57850343,45850343,2017,15850343,37.738911904761906,2010
